BASE_YEAR,BASE_QUARTER,BASE_MT,BASE_DAY,MT_WEEK_ODR,WEEK_ODR,CTPRVN_NM,KOREA_MOVIE_ADNC_CO,OVSEA_MOVIE_ADNC_CO,MOVIE_ADNC_CO,KOREA_MOVIE_SALES_PRICE,OVSEA_MOVIE_SALES_PRICE,MOVIE_SALES_PRICE,DAY_AVRG_KOREA_MOVIE_SCRNG_CO,DAY_AVRG_OVSEA_MOVIE_SCRNG_CO,DAY_AVRG_MOVIE_SCRNG_CO
2019,1,01,06,1,1,강원도,28043,64782,92825,227830300,516961400,744791700,5.29,13.71,19
2019,1,01,13,2,2,강원도,57925,32632,90557,460859470,250670310,711529780,6.86,13.57,20
2019,1,01,20,3,3,강원도,55885,24927,80812,441536430,194795230,636331660,6.71,14.14,21
2019,1,01,27,4,4,강원도,107270,10365,117635,880833990,76777680,957611670,6.57,15.29,22
2019,1,02,03,5,5,강원도,157628,19831,177459,1231994660,149009150,1381003810,8.29,12.14,20
2019,1,02,10,1,6,강원도,183453,47815,231268,1544524430,404249850,1948774280,7.43,10.57,18
2019,1,02,17,2,7,강원도,75988,28172,104160,596183160,227530510,823713670,6.14,12.86,19
2019,1,02,24,3,8,강원도,77688,16881,94569,614758980,127208630,741967610,6.29,17.14,23
2019,1,03,03,4,9,강원도,87029,11192,98221,662286740,80826860,743113600,7.14,19.43,27
2019,1,03,10,1,10,강원도,22058,74558,96616,177158220,618318770,795476990,6.86,12.57,19
2019,1,03,17,2,11,강원도,9603,50931,60534,75648780,415768590,491417370,7.71,12,20
2019,1,03,24,3,12,강원도,46030,21524,67554,378979560,174913020,553892580,8.29,11.57,20
2019,1,03,31,4,13,강원도,33265,40976,74241,253949500,322483250,576432750,7.71,13.71,21
2019,2,04,07,1,14,강원도,23228,30840,54068,183463400,251208200,434671600,8.29,13.57,22
2019,2,04,14,2,15,강원도,19667,20303,39970,155727350,163050870,318778220,6.29,17,23
2019,2,04,21,3,16,강원도,17956,11254,29210,139256770,91013240,230270010,9.43,19.43,29
2019,2,04,28,4,17,강원도,14500,169716,184216,103156540,1378641750,1481798290,10.71,13.71,24
2019,2,05,05,1,18,강원도,29347,118397,147744,224091790,955201720,1179293510,8.29,9.14,17
2019,2,05,12,2,19,강원도,38722,59266,97988,310183310,470932650,781115960,6.14,9.57,16
2019,2,05,19,3,20,강원도,60138,22268,82406,492034100,176704150,668738250,7.14,10.86,18
2019,2,05,26,4,21,강원도,48719,29095,77814,394230870,236498870,630729740,9.57,13,23
2019,2,06,02,5,22,강원도,102173,36947,139120,822202320,281702480,1103904800,11.14,11.43,23
2019,2,06,09,1,23,강원도,95090,61168,156258,768910590,490512450,1259423040,8.43,10.71,19
2019,2,06,16,2,24,강원도,36869,54840,91709,292178150,443789240,735967390,5.29,14.71,20
2019,2,06,23,3,25,강원도,39265,70618,109883,310174270,572209680,882383950,4.86,17.29,22
2019,2,06,30,4,26,강원도,27575,85063,112638,206164620,659582330,865746950,4.71,18.71,23
2019,3,07,07,1,27,강원도,8322,163172,171494,64131530,1304087670,1368219200,4.71,15.43,20
2019,3,07,14,2,28,강원도,12031,88932,100963,91758900,702577810,794336710,6.86,14.29,21
2019,3,07,21,3,29,강원도,5470,106462,111932,40422780,849821260,890244040,6.14,17.57,24
2019,3,07,28,4,30,강원도,32173,76830,109003,240455490,604381900,844837390,7.29,17.86,25
2019,3,08,04,1,31,강원도,120956,55291,176247,922674100,401502840,1324176940,5.43,10,15
2019,3,08,11,2,32,강원도,158988,21207,180195,1260725730,154337710,1415063440,8.43,9.29,18
2019,3,08,18,3,33,강원도,122425,61100,183525,961010210,487709590,1448719800,12.29,10.43,23
2019,3,08,25,4,34,강원도,80482,30739,111221,631632040,242353820,873985860,12.71,11.14,24
2019,3,09,01,5,35,강원도,67962,22126,90088,507966780,167903660,675870440,12.14,12.86,25
2019,3,09,08,1,36,강원도,43319,19816,63135,329353550,159415730,488769280,13.14,10.29,23
2019,3,09,15,2,37,강원도,154384,6632,161016,1261171570,51179150,1312350720,14.14,6.71,21
2019,3,09,22,3,38,강원도,58375,13325,71700,456274790,106515150,562789940,12.86,8.43,21
2019,3,09,29,4,39,강원도,51866,10220,62086,384867840,76451910,461319750,13.43,11.71,25
2019,4,10,06,1,40,강원도,62840,56562,119402,487723090,459848860,947571950,11.86,12.71,25
2019,4,10,13,2,41,강원도,40075,50692,90767,311296040,394474100,705770140,11.43,12.29,24
2019,4,10,20,3,42,강원도,22276,36045,58321,174649080,280994060,455643140,16.71,11.43,28
2019,4,10,27,4,43,강원도,35291,28291,63582,279378820,219202880,498581700,14.29,15.57,30
2019,4,11,03,5,44,강원도,36198,52641,88839,268542040,400294540,668836580,7.86,18.71,27
2019,4,11,10,1,45,강원도,46557,30910,77467,368726820,238382780,607109600,5.43,16.86,22
2019,4,11,17,2,46,강원도,57305,18674,75979,453025180,141695940,594721120,7.29,16.43,24
2019,4,11,24,3,47,강원도,36481,129335,165816,275747600,1014918560,1290666160,12.29,16,28
2019,4,12,01,1,48,강원도,27970,119016,146986,204312700,882143720,1086456420,12.14,11.14,23
2019,4,12,08,1,49,강원도,16180,80164,96344,120259180,620918740,741177920,10.71,13.29,24
2019,4,12,15,2,50,강원도,11847,74895,86742,82486720,582591180,665077900,11.14,15.43,27
2019,4,12,22,3,51,강원도,108806,30869,139675,862638160,234157360,1096795520,10.29,12.43,23
2019,4,12,29,4,52,강원도,155793,34886,190679,1224452560,270012320,1494464880,6.71,12.71,19
2019,1,01,06,1,1,경기도,253058,693269,946327,2200397900,5936026150,8136424050,10,14.86,25
2019,1,01,13,2,2,경기도,530097,354244,884341,4517700760,2907805290,7425506050,12.29,21,33
2019,1,01,20,3,3,경기도,508253,284406,792659,4288088390,2381551540,6669639930,12.71,25.14,38
2019,1,01,27,4,4,경기도,999440,126017,1125457,8713465940,1004328970,9717794910,13.14,25.43,39
2019,1,02,03,5,5,경기도,1415333,212125,1627458,11679170590,1721377440,13400548030,14.29,19.57,34
2019,1,02,10,1,6,경기도,1680293,513879,2194172,14921593070,4693500600,19615093670,11.71,17.57,29
2019,1,02,17,2,7,경기도,673166,329812,1002978,5562931440,2784479280,8347410720,10.86,20.29,31
2019,1,02,24,3,8,경기도,707980,218983,926963,5884672900,1748753510,7633426410,11.57,25.71,37
2019,1,03,03,4,9,경기도,813250,155648,968898,6517610360,1194999460,7712609820,13.43,28.14,42
2019,1,03,10,1,10,경기도,180190,807402,987592,1523051010,7157400290,8680451300,11.57,20.14,32
2019,1,03,17,2,11,경기도,82496,523322,605818,686407770,4618532510,5304940280,12.71,20,33
2019,1,03,24,3,12,경기도,434341,227991,662332,3839934880,1977226980,5817161860,13.71,23.57,37
2019,1,03,31,4,13,경기도,307501,436028,743529,2497022050,3594750200,6091772250,16,26.43,42
2019,2,04,07,1,14,경기도,203553,313413,516966,1723585200,2688250710,4411835910,18,26.71,45
2019,2,04,14,2,15,경기도,165677,209414,375091,1400406560,1803021520,3203428080,15,27.71,43
2019,2,04,21,3,16,경기도,147114,137388,284502,1217972790,1172424850,2390397640,16.14,36.86,53
2019,2,04,28,4,17,경기도,117667,1658155,1775822,911155810,14259235040,15170390850,15.57,32.43,48
2019,2,05,05,1,18,경기도,233235,1268387,1501622,1876728590,11037569000,12914297590,12.14,23.29,35
2019,2,05,12,2,19,경기도,323201,572757,895958,2738487940,5096588920,7835076860,15.57,18.43,34
2019,2,05,19,3,20,경기도,569269,216856,786125,4957394710,1940468940,6897863650,12.86,18.43,31
2019,2,05,26,4,21,경기도,434616,331036,765652,3780636190,2944581630,6725217820,13.86,19.86,34
2019,2,06,02,5,22,경기도,1009809,421120,1430929,8659990370,3395616060,12055606430,17.14,21.43,39
2019,2,06,09,1,23,경기도,938309,716619,1654928,8040087500,6173680860,14213768360,16.14,21.43,38
2019,2,06,16,2,24,경기도,324630,595515,920145,2770170430,5180846510,7951016940,13.43,22.14,36
2019,2,06,23,3,25,경기도,318689,780672,1099361,2756853040,6793308770,9550161810,13.29,24.57,38
2019,2,06,30,4,26,경기도,225306,932996,1158302,1800498060,7763179260,9563677320,11.71,23,35
2019,3,07,07,1,27,경기도,73339,1634342,1707681,569852390,13954925330,14524777720,11.43,21.43,33
2019,3,07,14,2,28,경기도,108340,948200,1056540,860846570,8133726520,8994573090,13.71,24.43,38
2019,3,07,21,3,29,경기도,55668,1064087,1119755,388509950,9388845240,9777355190,12.57,28.43,41
2019,3,07,28,4,30,경기도,239719,747425,987144,2019369190,6432641430,8452010620,12.43,26.14,39
2019,3,08,04,1,31,경기도,1125028,608201,1733229,9237665910,4771161570,14008827480,12,22,34
2019,3,08,11,2,32,경기도,1380075,233700,1613775,11813515910,1845560330,13659076240,13.86,20,34
2019,3,08,18,3,33,경기도,1012374,613889,1626263,8675110950,5396934380,14072045330,15.29,21,36
2019,3,08,25,4,34,경기도,624176,298217,922393,5392769020,2589590170,7982359190,17.57,24.29,42
2019,3,09,01,5,35,경기도,556925,237619,794544,4485309200,1930184930,6415494130,17.43,22.86,40
2019,3,09,08,1,36,경기도,352574,204808,557382,2893333980,1741814220,4635148200,23.43,20.86,44
2019,3,09,15,2,37,경기도,1436248,65122,1501370,12783533090,531256320,13314789410,18.71,15.71,34
2019,3,09,22,3,38,경기도,479264,158005,637269,4021905610,1359097860,5381003470,18.86,18,37
2019,3,09,29,4,39,경기도,422872,124907,547779,3413601140,981134580,4394735720,20.43,22.29,43
2019,4,10,06,1,40,경기도,527882,619450,1147332,4426725450,5385347670,9812073120,18.43,21.29,40
2019,4,10,13,2,41,경기도,336283,513815,850098,2836276420,4383295320,7219571740,16.86,19.71,37
2019,4,10,20,3,42,경기도,186099,362447,548546,1569180370,3120181180,4689361550,26.57,20.14,47
2019,4,10,27,4,43,경기도,352141,277709,629850,3024733480,2332330620,5357064100,25.43,25,50
2019,4,11,03,5,44,경기도,364178,579174,943352,2886379560,4745115610,7631495170,14.43,28.29,43
2019,4,11,10,1,45,경기도,422184,314227,736411,3632359300,2664971000,6297330300,13.86,28.71,43
2019,4,11,17,2,46,경기도,496659,186783,683442,4256870030,1561056830,5817926860,15.71,30.71,46
2019,4,11,24,3,47,경기도,266420,1233555,1499975,2234536060,10549204320,12783740380,18.71,24.71,43
2019,4,12,01,1,48,경기도,243213,1184587,1427800,1938850340,9630152730,11569003070,18.57,18.14,37
2019,4,12,08,1,49,경기도,133176,784496,917672,1063372680,6631093140,7694465820,20.71,17.29,38
2019,4,12,15,2,50,경기도,72648,749212,821860,558380900,6343724900,6902105800,20.86,23.29,44
2019,4,12,22,3,51,경기도,964767,308357,1273124,8280209280,2536965620,10817174900,19,22.86,42
2019,4,12,29,4,52,경기도,1327391,429533,1756924,11120899160,3591910900,14712810060,12.29,18.43,31
2019,1,01,06,1,1,경상남도,57910,144119,202029,488388000,1184803900,1673191900,6.71,13.29,20
2019,1,01,13,2,2,경상남도,134543,59986,194529,1115910240,474541980,1590452220,9.29,15.86,25
2019,1,01,20,3,3,경상남도,124549,44834,169383,1028838190,362246620,1391084810,9.43,15.86,25
2019,1,01,27,4,4,경상남도,226323,18294,244617,1920629720,140476620,2061106340,7.14,19.71,27
2019,1,02,03,5,5,경상남도,318978,29586,348564,2590735240,233436340,2824171580,9.14,12.14,21
2019,1,02,10,1,6,경상남도,382982,95520,478502,3344686190,838145280,4182831470,7.14,11.57,19
2019,1,02,17,2,7,경상남도,150813,50938,201751,1245493840,423585050,1669078890,7,16.14,23
2019,1,02,24,3,8,경상남도,156093,33442,189535,1289715780,261523550,1551239330,7.57,18.71,26
2019,1,03,03,4,9,경상남도,176314,22244,198558,1385421190,165772380,1551193570,9,19.43,28
2019,1,03,10,1,10,경상남도,42415,147055,189470,354177020,1257755780,1611932800,8.43,17.14,26
2019,1,03,17,2,11,경상남도,17192,95483,112675,143674590,812908190,956582780,9,14.29,23
2019,1,03,24,3,12,경상남도,93368,35978,129346,802184360,301507510,1103691870,8.71,13.14,22
2019,1,03,31,4,13,경상남도,63679,67013,130692,502420240,529463400,1031883640,10,16,26
2019,2,04,07,1,14,경상남도,51362,56149,107511,422766990,461695780,884462770,9.71,17.29,27
2019,2,04,14,2,15,경상남도,44649,39662,84311,364813250,324522850,689336100,6.43,21.43,28
2019,2,04,21,3,16,경상남도,36796,23279,60075,290194500,188453250,478647750,9.71,20.71,30
2019,2,04,28,4,17,경상남도,30512,338628,369140,231888420,2776316940,3008205360,9.57,17,27
2019,2,05,05,1,18,경상남도,63254,243916,307170,494779060,2017496650,2512275710,8,12.57,21
2019,2,05,12,2,19,경상남도,84166,113319,197485,689810420,935666410,1625476830,8.29,12.71,21
2019,2,05,19,3,20,경상남도,151301,41554,192855,1271129460,343528700,1614658160,8.29,11.71,20
2019,2,05,26,4,21,경상남도,112581,62875,175456,938446960,518427280,1456874240,11.29,12.57,24
2019,2,06,02,5,22,경상남도,230348,91206,321554,1891233870,699528570,2590762440,10.86,13.14,24
2019,2,06,09,1,23,경상남도,186846,138102,324948,1568025660,1132738470,2700764130,7,19.29,26
2019,2,06,16,2,24,경상남도,66509,110987,177496,556937190,927839740,1484776930,8.57,15.43,24
2019,2,06,23,3,25,경상남도,79515,128764,208279,673871740,1070844320,1744716060,7.14,17.86,25
2019,2,06,30,4,26,경상남도,58596,172932,231528,471148660,1388483020,1859631680,5.86,16.86,23
2019,3,07,07,1,27,경상남도,14997,333870,348867,123609690,2744536280,2868145970,6.14,17.29,23
2019,3,07,14,2,28,경상남도,24711,172593,197304,205711070,1419015170,1624726240,7.57,14,22
2019,3,07,21,3,29,경상남도,10160,201617,211777,81574860,1692351220,1773926080,6.86,16.14,23
2019,3,07,28,4,30,경상남도,56943,132062,189005,468309690,1092055200,1560364890,8,17.57,26
2019,3,08,04,1,31,경상남도,274116,117214,391330,2189035900,897101160,3086137060,7,17.14,24
2019,3,08,11,2,32,경상남도,344975,44865,389840,2871316570,344405330,3215721900,10.29,14.57,25
2019,3,08,18,3,33,경상남도,234627,138221,372848,1959594300,1176596140,3136190440,10.14,14.71,25
2019,3,08,25,4,34,경상남도,153509,64599,218108,1287053870,544440770,1831494640,12.29,15.57,28
2019,3,09,01,5,35,경상남도,131430,49387,180817,1025857680,391155670,1417013350,12.57,16.43,29
2019,3,09,08,1,36,경상남도,83174,40840,124014,664439330,338140880,1002580210,16,19.86,36
2019,3,09,15,2,37,경상남도,336421,9074,345495,2926189050,73558810,2999747860,16.86,10.29,27
2019,3,09,22,3,38,경상남도,115928,23934,139862,959935180,201800120,1161735300,15.14,11.14,26
2019,3,09,29,4,39,경상남도,120137,18937,139074,946663540,144265010,1090928550,14.57,14.14,29
2019,4,10,06,1,40,경상남도,134348,97864,232212,1107794570,816941750,1924736320,13.86,14.14,28
2019,4,10,13,2,41,경상남도,85669,87597,173266,707355560,722787720,1430143280,12.71,14.43,27
2019,4,10,20,3,42,경상남도,47383,66637,114020,395441320,551036140,946477460,15,12.14,27
2019,4,10,27,4,43,경상남도,76250,48474,124724,638477440,393478880,1031956320,13.71,15.29,29
2019,4,11,03,5,44,경상남도,78685,108723,187408,607500400,850627600,1458128000,8.14,16.57,25
2019,4,11,10,1,45,경상남도,97617,60822,158439,815129740,490424500,1305554240,8.14,19,27
2019,4,11,17,2,46,경상남도,118676,32093,150769,987002380,256965580,1243967960,8.29,14,22
2019,4,11,24,3,47,경상남도,66527,252276,318803,545761240,2036763620,2582524860,10.71,14.29,25
2019,4,12,01,1,48,경상남도,55301,215577,270878,432659540,1664977440,2097636980,12.14,11.43,24
2019,4,12,08,1,49,경상남도,35134,161642,196776,272308620,1278632860,1550941480,11.14,12.43,24
2019,4,12,15,2,50,경상남도,19917,141033,160950,154378340,1127382720,1281761060,12,15.71,28
2019,4,12,22,3,51,경상남도,226177,47070,273247,1884923480,368909560,2253833040,8.14,13,21
2019,4,12,29,4,52,경상남도,318862,63059,381921,2592509560,495332920,3087842480,8.86,11.29,20
2019,1,01,06,1,1,경상북도,39401,86515,125916,327029650,693436500,1020466150,5.86,10.71,17
2019,1,01,13,2,2,경상북도,86616,40695,127311,706052100,315126750,1021178850,9.14,14.14,23
2019,1,01,20,3,3,경상북도,81178,27626,108804,657355590,217718580,875074170,11.29,14.14,25
2019,1,01,27,4,4,경상북도,149396,11532,160928,1244861560,83352310,1328213870,10.29,16.43,27
2019,1,02,03,5,5,경상북도,218624,21009,239633,1730902300,149410230,1880312530,12.57,11.29,24
2019,1,02,10,1,6,경상북도,255993,54733,310726,2196543380,446900520,2643443900,11.57,9,21
2019,1,02,17,2,7,경상북도,99378,29942,129320,808761470,234513020,1043274490,8.57,12.43,21
2019,1,02,24,3,8,경상북도,99495,19906,119401,809654660,147557670,957212330,10.43,13.86,24
2019,1,03,03,4,9,경상북도,113638,10551,124189,873836500,76227390,950063890,12.86,16.14,29
2019,1,03,10,1,10,경상북도,26354,88398,114752,215006550,726534240,941540790,10.71,10.14,21
2019,1,03,17,2,11,경상북도,12970,57971,70941,102579970,480260850,582840820,11.29,9,20
2019,1,03,24,3,12,경상북도,62033,22930,84963,521620440,185659710,707280150,10.29,9.43,20
2019,1,03,31,4,13,경상북도,43321,43665,86986,335925220,336536720,672461940,9.29,13.14,22
2019,2,04,07,1,14,경상북도,30672,31994,62666,247975150,259332840,507307990,8,14.71,23
2019,2,04,14,2,15,경상북도,27824,22802,50626,222740090,185489030,408229120,9,14.57,24
2019,2,04,21,3,16,경상북도,22631,12725,35356,176694420,102193340,278887760,11.14,16.29,27
2019,2,04,28,4,17,경상북도,18615,205708,224323,136292340,1631287440,1767579780,11.86,10.29,22
2019,2,05,05,1,18,경상북도,39399,148242,187641,303346840,1185773960,1489120800,11.43,6.86,18
2019,2,05,12,2,19,경상북도,52285,66951,119236,423763470,534751800,958515270,9.43,9.43,19
2019,2,05,19,3,20,경상북도,90738,23613,114351,755861400,188168100,944029500,8.86,8.43,17
2019,2,05,26,4,21,경상북도,68718,32331,101049,566908060,262858800,829766860,10,9.57,20
2019,2,06,02,5,22,경상북도,133336,47954,181290,1088622680,361227150,1449849830,11.57,6.71,18
2019,2,06,09,1,23,경상북도,125262,82529,207791,1026314720,658711200,1685025920,10,9,19
2019,2,06,16,2,24,경상북도,43511,63873,107384,356918840,520615680,877534520,6.43,12.71,19
2019,2,06,23,3,25,경상북도,51725,78284,130009,431970220,634853680,1066823900,6.14,14.43,21
2019,2,06,30,4,26,경상북도,40858,101025,141883,321239480,791102980,1112342460,6.86,13.86,21
2019,3,07,07,1,27,경상북도,9226,181217,190443,71229580,1451703360,1522932940,9.14,14.43,24
2019,3,07,14,2,28,경상북도,17092,114808,131900,135609200,909253720,1044862920,9.29,12.29,22
2019,3,07,21,3,29,경상북도,6856,130164,137020,52378740,1049154380,1101533120,9.86,14.57,24
2019,3,07,28,4,30,경상북도,37905,82404,120309,302166620,658814530,960981150,10,12.43,22
2019,3,08,04,1,31,경상북도,172286,69205,241491,1338407440,516766080,1855173520,7.43,9.86,17
2019,3,08,11,2,32,경상북도,211777,26414,238191,1722698230,197204840,1919903070,12.57,9.43,22
2019,3,08,18,3,33,경상북도,153454,81631,235085,1245271890,675134440,1920406330,14.29,10.71,25
2019,3,08,25,4,34,경상북도,103695,38618,142313,847177200,316697120,1163874320,14.57,14.43,29
2019,3,09,01,5,35,경상북도,87187,27755,114942,663979480,213429910,877409390,13.14,13.71,27
2019,3,09,08,1,36,경상북도,55658,25481,81139,431499710,205762350,637262060,15.86,13.86,30
2019,3,09,15,2,37,경상북도,221982,5779,227761,1891209290,45197900,1936407190,13.86,9,23
2019,3,09,22,3,38,경상북도,79791,13565,93356,648734040,111353580,760087620,14.14,10.29,24
2019,3,09,29,4,39,경상북도,75367,9118,84485,583455190,69087140,652542330,15,10.86,26
2019,4,10,06,1,40,경상북도,89826,62709,152535,721723540,513664910,1235388450,15,10.71,26
2019,4,10,13,2,41,경상북도,56981,56405,113386,459151300,455939960,915091260,14.14,10.43,25
2019,4,10,20,3,42,경상북도,30302,40841,71143,243528120,330418100,573946220,18.29,10.43,29
2019,4,10,27,4,43,경상북도,46634,31918,78552,381230800,256979740,638210540,14.14,11.86,26
2019,4,11,03,5,44,경상북도,48657,68685,117342,368840520,524360000,893200520,10.57,14.43,25
2019,4,11,10,1,45,경상북도,61765,38390,100155,504836860,303251240,808088100,8,14.29,22
2019,4,11,17,2,46,경상북도,76979,20792,97771,627673060,162988500,790661560,10.86,13.43,24
2019,4,11,24,3,47,경상북도,44431,164803,209234,350566460,1289538120,1640104580,14.29,13.43,28
2019,4,12,01,1,48,경상북도,36085,142930,179015,277277560,1066756240,1344033800,13.43,9.29,23
2019,4,12,08,1,49,경상북도,21859,88749,110608,167694040,687557820,855251860,14.29,9.86,24
2019,4,12,15,2,50,경상북도,15377,89254,104631,112622120,693606800,806228920,13.43,12.86,26
2019,4,12,22,3,51,경상북도,156691,30479,187170,1266550940,232761480,1499312420,10.14,9.29,19
2019,4,12,29,4,52,경상북도,212320,38222,250542,1693749420,296751280,1990500700,8,9.57,18
2019,1,01,06,1,1,광주광역시,43152,88742,131894,363977950,740637850,1104615800,8,13.14,21
2019,1,01,13,2,2,광주광역시,91394,44303,135697,754327180,352472100,1106799280,8.71,15.14,24
2019,1,01,20,3,3,광주광역시,89222,32910,122132,726322050,270486550,996808600,8.71,18.14,27
2019,1,01,27,4,4,광주광역시,156946,13297,170243,1324690730,108400760,1433091490,8.71,17.57,26
2019,1,02,03,5,5,광주광역시,211881,21487,233368,1704803770,178916650,1883720420,8.86,11.43,20
2019,1,02,10,1,6,광주광역시,244651,66298,310949,2113348330,607463520,2720811850,8.57,11,20
2019,1,02,17,2,7,광주광역시,102847,42676,145523,828768670,355947280,1184715950,7,14,21
2019,1,02,24,3,8,광주광역시,110574,26234,136808,895870010,208506640,1104376650,8.43,17.57,26
2019,1,03,03,4,9,광주광역시,124001,15809,139810,968467710,121303800,1089771510,9.43,19.57,29
2019,1,03,10,1,10,광주광역시,28702,99186,127888,235700580,862756160,1098456740,8,15.14,23
2019,1,03,17,2,11,광주광역시,12197,67224,79421,99922310,574706610,674628920,8.14,15.14,23
2019,1,03,24,3,12,광주광역시,71226,28858,100084,612219480,242078800,854298280,8.71,13.71,22
2019,1,03,31,4,13,광주광역시,46711,53782,100493,375279860,426704530,801984390,9,12.14,21
2019,2,04,07,1,14,광주광역시,35518,39879,75397,295264150,330096890,625361040,9,13.29,22
2019,2,04,14,2,15,광주광역시,33654,30117,63771,277100910,250451830,527552740,7.57,17,25
2019,2,04,21,3,16,광주광역시,29092,17539,46631,233300150,145352110,378652260,11,21.14,32
2019,2,04,28,4,17,광주광역시,17398,209923,227321,132253520,1787360730,1919614250,10.29,17.43,28
2019,2,05,05,1,18,광주광역시,41222,155915,197137,326060540,1332120370,1658180910,7.57,11.71,19
2019,2,05,12,2,19,광주광역시,58783,74894,133677,486920860,638961740,1125882600,6.86,10.71,18
2019,2,05,19,3,20,광주광역시,102186,27956,130142,869268470,240414390,1109682860,7.57,11.43,19
2019,2,05,26,4,21,광주광역시,74830,38905,113735,630792930,338965830,969758760,11.29,11.43,23
2019,2,06,02,5,22,광주광역시,143325,54382,197707,1197695260,434964930,1632660190,12.57,9.86,22
2019,2,06,09,1,23,광주광역시,133110,98088,231198,1092129890,821209740,1913339630,8.71,11.29,20
2019,2,06,16,2,24,광주광역시,48067,82128,130195,392895860,694666890,1087562750,8.57,13.71,22
2019,2,06,23,3,25,광주광역시,65466,98116,163582,552989870,826203180,1379193050,7.86,14.43,22
2019,2,06,30,4,26,광주광역시,49252,118678,167930,393389530,964134990,1357524520,6.14,16.86,23
2019,3,07,07,1,27,광주광역시,13340,206970,220310,107625510,1737566210,1845191720,7,16.86,24
2019,3,07,14,2,28,광주광역시,20681,134651,155332,165025730,1093900910,1258926640,7,15.29,22
2019,3,07,21,3,29,광주광역시,9058,145941,154999,72317780,1231402940,1303720720,6.86,19.57,26
2019,3,07,28,4,30,광주광역시,40075,97274,137349,327192770,800833220,1128025990,8,16.14,24
2019,3,08,04,1,31,광주광역시,188440,80982,269422,1507382840,621141600,2128524440,7.71,14,22
2019,3,08,11,2,32,광주광역시,223154,27565,250719,1833320230,214052390,2047372620,10.57,11.14,22
2019,3,08,18,3,33,광주광역시,166321,95008,261329,1368324150,821351740,2189675890,11.57,11.14,23
2019,3,08,25,4,34,광주광역시,111544,46143,157687,923024450,391451770,1314476220,13.14,11.57,25
2019,3,09,01,5,35,광주광역시,94426,36188,130614,737741620,289137100,1026878720,13.71,11.71,25
2019,3,09,08,1,36,광주광역시,55724,33875,89599,453363740,279183140,732546880,14.86,10.86,26
2019,3,09,15,2,37,광주광역시,226083,10718,236801,1957603870,86540530,2044144400,14.43,8.14,23
2019,3,09,22,3,38,광주광역시,84958,20549,105507,695048710,177723520,872772230,13.14,9.57,23
2019,3,09,29,4,39,광주광역시,74206,14106,88312,586626860,111549920,698176780,12,12.57,25
2019,4,10,06,1,40,광주광역시,94095,73559,167654,774740050,625705720,1400445770,12.43,12,24
2019,4,10,13,2,41,광주광역시,60689,60260,120949,497362880,501057060,998419940,12,11.71,24
2019,4,10,20,3,42,광주광역시,34672,51816,86488,280134700,423202840,703337540,16.71,11.71,28
2019,4,10,27,4,43,광주광역시,51587,37060,88647,430651160,299706460,730357620,12.43,15.71,28
2019,4,11,03,5,44,광주광역시,55194,71858,127052,428629780,573123640,1001753420,8.29,16.86,25
2019,4,11,10,1,45,광주광역시,69989,41478,111467,587958000,337181900,925139900,5.29,15.86,21
2019,4,11,17,2,46,광주광역시,92502,25194,117696,764348720,198492180,962840900,7.71,17,25
2019,4,11,24,3,47,광주광역시,52190,162867,215057,420713280,1350096180,1770809460,9.71,12.14,22
2019,4,12,01,1,48,광주광역시,45772,144239,190011,348963120,1135895140,1484858260,12.43,9.29,22
2019,4,12,08,1,49,광주광역시,29023,100144,129167,215720740,817554640,1033275380,12.71,10.71,23
2019,4,12,15,2,50,광주광역시,18625,99312,117937,132627460,802685000,935312460,10.86,14.86,26
2019,4,12,22,3,51,광주광역시,154295,41329,195624,1257414520,325176340,1582590860,8.43,13,21
2019,4,12,29,4,52,광주광역시,216918,50485,267403,1736634100,402631020,2139265120,8.29,12.43,21
2019,1,01,06,1,1,대구광역시,58622,136585,195207,520935900,1185166450,1706102350,8.86,14,23
2019,1,01,13,2,2,대구광역시,119966,73103,193069,1047525050,617548700,1665073750,10.14,16.29,26
2019,1,01,20,3,3,대구광역시,117548,53283,170831,1017602340,450542960,1468145300,9.86,19.71,30
2019,1,01,27,4,4,대구광역시,219899,21304,241203,1954753270,169317880,2124071150,9.57,20,30
2019,1,02,03,5,5,대구광역시,308803,33926,342729,2594635650,282523030,2877158680,11,13,24
2019,1,02,10,1,6,대구광역시,352146,96067,448213,3215953730,896721770,4112675500,8.71,10.71,19
2019,1,02,17,2,7,대구광역시,142368,62508,204876,1204865640,540225430,1745091070,10,15.14,25
2019,1,02,24,3,8,대구광역시,154294,40750,195044,1315576990,328515430,1644092420,9.43,20.57,30
2019,1,03,03,4,9,대구광역시,176342,28529,204871,1419217150,213494160,1632711310,10.57,22.43,33
2019,1,03,10,1,10,대구광역시,41107,158258,199365,356507560,1418901350,1775408910,9.71,17,27
2019,1,03,17,2,11,대구광역시,18366,103675,122041,155259610,928479530,1083739140,11.43,17.43,29
2019,1,03,24,3,12,대구광역시,98317,44251,142568,875088590,386402070,1261490660,12.57,18.14,31
2019,1,03,31,4,13,대구광역시,82682,83542,166224,676638200,681292170,1357930370,12.43,17.86,30
2019,2,04,07,1,14,대구광역시,49977,65318,115295,426441010,558803560,985244570,10.71,16.14,27
2019,2,04,14,2,15,대구광역시,40635,46965,87600,347664850,401128660,748793510,10.43,19.57,30
2019,2,04,21,3,16,대구광역시,30809,30037,60846,257140190,252403530,509543720,12.57,24,37
2019,2,04,28,4,17,대구광역시,20160,319271,339431,156574030,2745251560,2901825590,13,19,32
2019,2,05,05,1,18,대구광역시,49145,246206,295351,405255310,2155901140,2561156450,10,15.57,26
2019,2,05,12,2,19,대구광역시,75111,112485,187596,649691250,1010399540,1660090790,11.43,14,25
2019,2,05,19,3,20,대구광역시,135129,45371,180500,1182161010,395595140,1577756150,10.57,14.29,25
2019,2,05,26,4,21,대구광역시,99182,66974,166156,861289250,592738080,1454027330,14.86,15,30
2019,2,06,02,5,22,대구광역시,206493,94215,300708,1762951910,744477440,2507429350,14,14.86,29
2019,2,06,09,1,23,대구광역시,187967,144799,332766,1610794210,1227453450,2838247660,10.57,17.29,28
2019,2,06,16,2,24,대구광역시,68670,121847,190517,585773710,1050400940,1636174650,9.43,19.14,29
2019,2,06,23,3,25,대구광역시,79673,151796,231469,692398930,1306395570,1998794500,8.71,19.86,29
2019,2,06,30,4,26,대구광역시,60955,189496,250451,498032090,1558342880,2056374970,10.43,20.57,31
2019,3,07,07,1,27,대구광역시,15444,320166,335610,128519790,2738836150,2867355940,10.14,17,27
2019,3,07,14,2,28,대구광역시,30498,199808,230306,257070550,1700739140,1957809690,12.29,17.57,30
2019,3,07,21,3,29,대구광역시,11605,222382,233987,93797440,1945426530,2039223970,10,19.14,29
2019,3,07,28,4,30,대구광역시,53301,154915,208216,451011330,1314569980,1765581310,9.14,19.14,28
2019,3,08,04,1,31,대구광역시,266393,118726,385119,2183861690,925267130,3109128820,10.29,17.14,27
2019,3,08,11,2,32,대구광역시,311442,42967,354409,2673631360,332731440,3006362800,10.71,15.14,26
2019,3,08,18,3,33,대구광역시,206278,135438,341716,1773660720,1193630450,2967291170,11.86,15.57,27
2019,3,08,25,4,34,대구광역시,142384,69179,211563,1232769500,596488870,1829258370,13.71,16.29,30
2019,3,09,01,5,35,대구광역시,129894,53847,183741,1033094950,430891640,1463986590,14.57,16.29,31
2019,3,09,08,1,36,대구광역시,81523,48707,130230,679048810,406488550,1085537360,17.86,16.14,34
2019,3,09,15,2,37,대구광역시,322995,15182,338177,2898506570,125134240,3023640810,16.43,12.14,29
2019,3,09,22,3,38,대구광역시,116885,31481,148366,993228090,275611260,1268839350,16.43,11.57,28
2019,3,09,29,4,39,대구광역시,108471,25041,133512,876938670,192157750,1069096420,16,16.71,33
2019,4,10,06,1,40,대구광역시,134094,125041,259135,1127848260,1077788950,2205637210,15.14,14.86,30
2019,4,10,13,2,41,대구광역시,83041,98890,181931,705577160,837935180,1543512340,13.14,12.14,25
2019,4,10,20,3,42,대구광역시,47209,69248,116457,400489600,594532800,995022400,19.29,15.86,35
2019,4,10,27,4,43,대구광역시,73176,54741,127917,627084260,457784160,1084868420,16.43,19,35
2019,4,11,03,5,44,대구광역시,75503,116751,192254,595055640,943653580,1538709220,9.57,21.57,31
2019,4,11,10,1,45,대구광역시,99507,66521,166028,860732200,554872140,1415604340,9,19.71,29
2019,4,11,17,2,46,대구광역시,121751,38354,160105,1044000580,314016000,1358016580,9.57,20.86,30
2019,4,11,24,3,47,대구광역시,64617,238308,302925,544236920,2043757340,2587994260,11.43,15,26
2019,4,12,01,1,48,대구광역시,57240,219868,277108,458746400,1768985360,2227731760,13.71,11.57,25
2019,4,12,08,1,49,대구광역시,32239,146247,178486,260629160,1235023860,1495653020,14.29,14.14,28
2019,4,12,15,2,50,대구광역시,23494,151368,174862,195122660,1269884060,1465006720,14.71,18.57,33
2019,4,12,22,3,51,대구광역시,213368,59550,272918,1852521080,488467540,2340988620,11,14.57,26
2019,4,12,29,4,52,대구광역시,291022,83879,374901,2445023180,685323580,3130346760,9.71,14.43,24
2019,1,01,06,1,1,대전광역시,36537,90483,127020,321430400,782242350,1103672750,6.14,12.43,19
2019,1,01,13,2,2,대전광역시,82003,43931,125934,711614690,362199400,1073814090,6.71,14.14,21
2019,1,01,20,3,3,대전광역시,80608,34085,114693,694521460,290990350,985511810,6.57,16,23
2019,1,01,27,4,4,대전광역시,148327,15029,163356,1307217380,124096030,1431313410,7.86,17.29,25
2019,1,02,03,5,5,대전광역시,203633,26877,230510,1707502220,231345790,1938848010,7,9.57,17
2019,1,02,10,1,6,대전광역시,217106,64524,281630,1947802740,614213470,2562016210,5.86,9.29,15
2019,1,02,17,2,7,대전광역시,93001,40265,133266,775201200,350469040,1125670240,6.29,13.43,20
2019,1,02,24,3,8,대전광역시,104803,26718,131521,879234850,218923600,1098158450,5.86,17.71,24
2019,1,03,03,4,9,대전광역시,118864,19156,138020,959032830,149302590,1108335420,6.57,19.86,26
2019,1,03,10,1,10,대전광역시,27397,109321,136718,237784370,986219750,1224004120,8.71,13.29,22
2019,1,03,17,2,11,대전광역시,11224,72302,83526,96633290,651196890,747830180,8.86,13.29,22
2019,1,03,24,3,12,대전광역시,64837,29412,94249,583356880,260662840,844019720,8,13,21
2019,1,03,31,4,13,대전광역시,44495,59344,103839,369522580,497277230,866799810,7.86,14.57,22
2019,2,04,07,1,14,대전광역시,29286,42821,72107,252495380,375743120,628238500,6.43,14.71,21
2019,2,04,14,2,15,대전광역시,24102,29139,53241,210028070,256447420,466475490,6,18.14,24
2019,2,04,21,3,16,대전광역시,23400,17593,40993,196980830,153631400,350612230,8.14,22,30
2019,2,04,28,4,17,대전광역시,15647,220998,236645,122882130,1960453070,2083335200,7.57,16.43,24
2019,2,05,05,1,18,대전광역시,35246,170617,205863,289907090,1513620210,1803527300,5.43,13.14,19
2019,2,05,12,2,19,대전광역시,52144,74210,126354,449680420,666655920,1116336340,6.86,13.29,20
2019,2,05,19,3,20,대전광역시,89019,28703,117722,781798600,254792670,1036591270,7.29,12.29,20
2019,2,05,26,4,21,대전광역시,68249,44434,112683,599606670,393780340,993387010,10.57,13.29,24
2019,2,06,02,5,22,대전광역시,144138,60036,204174,1239652870,489127640,1728780510,12.57,12.14,25
2019,2,06,09,1,23,대전광역시,125290,98095,223385,1076599580,843102190,1919701770,7.29,13,20
2019,2,06,16,2,24,대전광역시,44110,83631,127741,378510420,726599340,1105109760,3,15,18
2019,2,06,23,3,25,대전광역시,49735,105729,155464,433768720,914408800,1348177520,3.86,16.29,20
2019,2,06,30,4,26,대전광역시,32325,127484,159809,263374330,1057156500,1320530830,5.57,17.14,23
2019,3,07,07,1,27,대전광역시,8375,232986,241361,70347960,1987538050,2057886010,5.71,14,20
2019,3,07,14,2,28,대전광역시,16947,123305,140252,134942790,1054311710,1189254500,5.71,14,20
2019,3,07,21,3,29,대전광역시,9122,146198,155320,61808160,1282911700,1344719860,5.71,17.86,24
2019,3,07,28,4,30,대전광역시,35989,99447,135436,305311820,855503840,1160815660,6.71,17.71,24
2019,3,08,04,1,31,대전광역시,163645,72650,236295,1353641120,573153380,1926794500,5.86,15.14,21
2019,3,08,11,2,32,대전광역시,197494,27649,225143,1699777150,219829410,1919606560,7.71,12.86,21
2019,3,08,18,3,33,대전광역시,148250,82562,230812,1272475170,730533710,2003008880,9.71,12.71,22
2019,3,08,25,4,34,대전광역시,95330,41761,137091,831114720,368063600,1199178320,12.14,13.57,26
2019,3,09,01,5,35,대전광역시,88567,33937,122504,717503760,278635690,996139450,11.14,15,26
2019,3,09,08,1,36,대전광역시,55448,30533,85981,463172760,263953410,727126170,14.29,13.14,27
2019,3,09,15,2,37,대전광역시,207021,8347,215368,1838022200,69741770,1907763970,12.29,8.14,20
2019,3,09,22,3,38,대전광역시,75208,23570,98778,644142940,207012310,851155250,12.43,9.14,22
2019,3,09,29,4,39,대전광역시,67738,15200,82938,543810540,120162570,663973110,11.71,13.86,26
2019,4,10,06,1,40,대전광역시,88747,82382,171129,746741320,710496650,1457237970,12.71,12.14,25
2019,4,10,13,2,41,대전광역시,58058,69928,127986,489203720,596509560,1085713280,12.29,11.43,24
2019,4,10,20,3,42,대전광역시,28759,47455,76214,244813840,409548200,654362040,14.71,11.57,26
2019,4,10,27,4,43,대전광역시,51920,38261,90181,445084120,322585700,767669820,11.14,14.86,26
2019,4,11,03,5,44,대전광역시,49450,80132,129582,395490320,649002190,1044492510,6.43,17,23
2019,4,11,10,1,45,대전광역시,64466,43304,107770,558460620,364566700,923027320,4.29,16.71,21
2019,4,11,17,2,46,대전광역시,77416,24688,102104,666319700,206057700,872377400,6.57,20,27
2019,4,11,24,3,47,대전광역시,42653,178957,221610,361853040,1532859440,1894712480,8.57,17,26
2019,4,12,01,1,48,대전광역시,41019,157098,198117,331147220,1288402900,1619550120,12.29,12.86,25
2019,4,12,08,1,49,대전광역시,22061,106669,128730,181074500,910451300,1091525800,11.86,11.43,23
2019,4,12,15,2,50,대전광역시,12294,110785,123079,98460520,933798380,1032258900,10.14,16.29,26
2019,4,12,22,3,51,대전광역시,144760,40588,185348,1259086380,340919320,1600005700,6.71,13.14,20
2019,4,12,29,4,52,대전광역시,199246,57359,256605,1688756700,480891280,2169647980,4.43,12.14,17
2019,1,01,06,1,1,부산광역시,82373,182815,265188,716617450,1567429350,2284046800,11.43,19.29,31
2019,1,01,13,2,2,부산광역시,165962,90307,256269,1420731070,748333410,2169064480,13.43,21.29,35
2019,1,01,20,3,3,부산광역시,162358,72214,234572,1375606330,603497550,1979103880,13.14,24.14,37
2019,1,01,27,4,4,부산광역시,298620,35343,333963,2607139180,276763740,2883902920,12.43,23.14,36
2019,1,02,03,5,5,부산광역시,402302,45940,448242,3333873290,378020030,3711893320,13.71,17.29,31
2019,1,02,10,1,6,부산광역시,472526,131985,604511,4229902960,1189744810,5419647770,11.86,18.86,31
2019,1,02,17,2,7,부산광역시,198625,82094,280719,1651001580,686566290,2337567870,9.86,19.43,29
2019,1,02,24,3,8,부산광역시,218861,55160,274021,1808046020,442542610,2250588630,10.14,24.86,35
2019,1,03,03,4,9,부산광역시,247616,40496,288112,1976259330,306379230,2282638560,10.86,28.14,39
2019,1,03,10,1,10,부산광역시,66417,213900,280317,557958860,1875014640,2432973500,11.14,23,34
2019,1,03,17,2,11,부산광역시,28304,148351,176655,233214830,1286284690,1519499520,11,25.14,36
2019,1,03,24,3,12,부산광역시,138173,63436,201609,1204082870,536501990,1740584860,11.43,22.71,34
2019,1,03,31,4,13,부산광역시,100410,117167,217577,809933340,938805940,1748739280,12.14,24.57,37
2019,2,04,07,1,14,부산광역시,71979,93190,165169,601599210,786579440,1388178650,15,21.43,36
2019,2,04,14,2,15,부산광역시,61521,67451,128972,511277280,566640570,1077917850,16,22.71,39
2019,2,04,21,3,16,부산광역시,54685,44352,99037,444001630,360527570,804529200,14.71,28.86,44
2019,2,04,28,4,17,부산광역시,35396,448354,483750,274248250,3784743500,4058991750,10.86,22.29,33
2019,2,05,05,1,18,부산광역시,71365,321572,392937,573181750,2759937180,3333118930,9.57,22.29,32
2019,2,05,12,2,19,부산광역시,109611,152846,262457,906005490,1319900370,2225905860,14.43,19.29,34
2019,2,05,19,3,20,부산광역시,201398,62169,263567,1696731910,528864550,2225596460,12.29,16.43,29
2019,2,05,26,4,21,부산광역시,158620,91782,250402,1322632000,777462610,2100094610,14.43,17.43,32
2019,2,06,02,5,22,부산광역시,328439,129609,458048,2717391320,1016754830,3734146150,16.29,17.71,34
2019,2,06,09,1,23,부산광역시,268782,186422,455204,2276211190,1574771880,3850983070,15.29,17.86,33
2019,2,06,16,2,24,부산광역시,96043,158568,254611,803790080,1362912240,2166702320,12,23.43,35
2019,2,06,23,3,25,부산광역시,108728,192353,301081,925615420,1649810970,2575426390,9.43,26.43,36
2019,2,06,30,4,26,부산광역시,84513,242688,327201,674284740,2000072070,2674356810,7.86,23.29,31
2019,3,07,07,1,27,부산광역시,23473,435344,458817,189274910,3669596470,3858871380,9.43,19.71,29
2019,3,07,14,2,28,부산광역시,40269,238961,279230,332752540,2030517780,2363270320,9.29,18.29,28
2019,3,07,21,3,29,부산광역시,18874,269697,288571,154216800,2328938530,2483155330,9.57,25.57,35
2019,3,07,28,4,30,부산광역시,76835,194108,270943,638653490,1633347570,2272001060,9.57,25.14,35
2019,3,08,04,1,31,부산광역시,350363,152916,503279,2832208930,1194882360,4027091290,9.43,20.14,30
2019,3,08,11,2,32,부산광역시,400618,52167,452785,3384125470,412202110,3796327580,12.57,18.29,31
2019,3,08,18,3,33,부산광역시,291862,177775,469637,2476956870,1535651450,4012608320,15.29,19.29,35
2019,3,08,25,4,34,부산광역시,200536,92451,292987,1696323110,786767780,2483090890,16.43,20.71,37
2019,3,09,01,5,35,부산광역시,174421,82655,257076,1382357690,651929360,2034287050,16.29,22.86,39
2019,3,09,08,1,36,부산광역시,115658,68309,183967,951435000,567444520,1518879520,19,20.86,40
2019,3,09,15,2,37,부산광역시,422944,22326,445270,3711520290,179259020,3890779310,18.86,15.29,34
2019,3,09,22,3,38,부산광역시,151066,42639,193705,1252308750,366736790,1619045540,14.57,13.14,28
2019,3,09,29,4,39,부산광역시,158193,37297,195490,1264542880,291228240,1555771120,14.29,17.71,32
2019,4,10,06,1,40,부산광역시,181290,152885,334175,1520655520,1306090620,2826746140,14.71,13.57,28
2019,4,10,13,2,41,부산광역시,117304,133868,251172,984832380,1134721640,2119554020,14.57,14.14,29
2019,4,10,20,3,42,부산광역시,70499,100752,171251,579886160,846954840,1426841000,24.29,17,41
2019,4,10,27,4,43,부산광역시,108185,81272,189457,902934900,663441660,1566376560,20.43,21.14,42
2019,4,11,03,5,44,부산광역시,106012,157503,263515,820431100,1244610780,2065041880,12.57,22.43,35
2019,4,11,10,1,45,부산광역시,136953,92223,229176,1155598020,754603700,1910201720,11.14,23.43,35
2019,4,11,17,2,46,부산광역시,170982,51812,222794,1430249420,415751680,1846001100,11.71,25.29,37
2019,4,11,24,3,47,부산광역시,102581,297646,400227,840521900,2469707230,3310229130,12.57,21.86,34
2019,4,12,01,1,48,부산광역시,87985,275443,363428,681588800,2171610440,2853199240,15.71,17.71,33
2019,4,12,08,1,49,부산광역시,50793,202041,252834,395076800,1664294360,2059371160,16.14,16.29,32
2019,4,12,15,2,50,부산광역시,38787,197819,236606,305037020,1614058660,1919095680,14.71,21.43,36
2019,4,12,22,3,51,부산광역시,289143,74518,363661,2430457440,606936420,3037393860,14.71,17.71,32
2019,4,12,29,4,52,부산광역시,395967,105075,501042,3227260960,851145500,4078406460,11.43,17.14,29
2019,1,01,06,1,1,서울특별시,238295,728077,966372,2119159327,6534694221,8653853548,19.14,33.86,53
2019,1,01,13,2,2,서울특별시,477038,419702,896740,4188591897,3650068124,7838660021,22.71,42.29,65
2019,1,01,20,3,3,서울특별시,478716,359327,838043,4140568863,3168628879,7309197742,24.71,43.57,68
2019,1,01,27,4,4,서울특별시,937198,186422,1123620,8370676080,1552931785,9923607865,22.29,40.14,62
2019,1,02,03,5,5,서울특별시,1273017,248962,1521979,10789028627,2170706986,12959735613,23.57,37.43,61
2019,1,02,10,1,6,서울특별시,1433740,551834,1985574,12938887060,5348545399,18287432459,19.57,32.29,52
2019,1,02,17,2,7,서울특별시,628733,384959,1013692,5298909560,3490618765,8789528325,20.29,40.43,61
2019,1,02,24,3,8,서울특별시,724747,293973,1018720,6081746783,2521670680,8603417463,18.43,46.86,65
2019,1,03,03,4,9,서울특별시,807031,253980,1061011,6594764471,2028182044,8622946515,19.43,50.71,70
2019,1,03,10,1,10,서울특별시,196489,903912,1100401,1681885800,8417076960,10098962760,19.86,42.86,63
2019,1,03,17,2,11,서울특별시,100632,636513,737145,842696200,5908355705,6751051905,20.43,43.29,64
2019,1,03,24,3,12,서울특별시,472722,317042,789764,4254115499,2848503440,7102618939,19.57,45.14,65
2019,1,03,31,4,13,서울특별시,340253,563663,903916,2835622275,4805781445,7641403720,24.86,47.29,72
2019,2,04,07,1,14,서울특별시,214920,417000,631920,1856875871,3692697820,5549573691,26.86,42.86,70
2019,2,04,14,2,15,서울특별시,168949,318930,487879,1444676290,2748617946,4193294236,26.57,49.57,76
2019,2,04,21,3,16,서울특별시,172801,220717,393518,1438604801,1888381978,3326986779,29.43,54.14,84
2019,2,04,28,4,17,서울특별시,97235,1632030,1729265,761106150,14665395806,15426501956,21.29,57.71,79
2019,2,05,05,1,18,서울특별시,192805,1307452,1500257,1597054870,11928066580,13525121450,21.29,52.71,74
2019,2,05,12,2,19,서울특별시,293745,648873,942618,2545560698,6165337046,8710897744,25.57,46.14,72
2019,2,05,19,3,20,서울특별시,552239,316742,868981,4871608500,2955458150,7827066650,25.43,43.86,69
2019,2,05,26,4,21,서울특별시,434301,427059,861360,3801204170,4047044160,7848248330,26,36.43,62
2019,2,06,02,5,22,서울특별시,1052725,490206,1542931,9218901688,4218075958,13436977646,24.43,36.29,61
2019,2,06,09,1,23,서울특별시,986912,762868,1749780,8583323747,6907513660,15490837407,22.29,36.29,59
2019,2,06,16,2,24,서울특별시,374800,699900,1074700,3242880220,6337841290,9580721510,20.71,43.29,64
2019,2,06,23,3,25,서울특별시,336840,902750,1239590,2929498540,8290188538,11219687078,18.43,48,66
2019,2,06,30,4,26,서울특별시,232307,1069622,1301929,1894269760,9325987780,11220257540,19.43,46.57,66
2019,3,07,07,1,27,서울특별시,80814,1638050,1718864,661540890,14640681810,15302222700,17.57,36.57,54
2019,3,07,14,2,28,서울특별시,135181,1070261,1205442,1093938660,9621177010,10715115670,20,41.57,62
2019,3,07,21,3,29,서울특별시,69800,1143739,1213539,553373850,10648953248,11202327098,20.86,47.43,68
2019,3,07,28,4,30,서울특별시,258333,820654,1078987,2182863573,7540674196,9723537769,20.57,41.43,62
2019,3,08,04,1,31,서울특별시,980690,601108,1581798,8294968790,5021867522,13316836312,19.14,39.14,58
2019,3,08,11,2,32,서울특별시,1223476,260273,1483749,10748043210,2193998933,12942042143,21,38.57,60
2019,3,08,18,3,33,서울특별시,920981,593902,1514883,8055823260,5390715205,13446538465,22.57,43.57,66
2019,3,08,25,4,34,서울특별시,619893,352887,972780,5395917940,3108107358,8504025298,26,49.43,75
2019,3,09,01,5,35,서울특별시,586493,298201,884694,4774424500,2458826176,7233250676,27.29,45.14,72
2019,3,09,08,1,36,서울특별시,370463,258418,628881,3052494999,2203471680,5255966679,31,40.14,71
2019,3,09,15,2,37,서울특별시,1223917,125853,1349770,11005912364,1032350440,12038262804,31.14,37.43,69
2019,3,09,22,3,38,서울특별시,451668,256443,708111,3798320730,2207120950,6005441680,29.71,39.86,70
2019,3,09,29,4,39,서울특별시,426654,248609,675263,3502021727,2008635058,5510656785,29.57,43.29,73
2019,4,10,06,1,40,서울특별시,514846,802559,1317405,4436543160,7133512390,11570055550,28.71,41.29,70
2019,4,10,13,2,41,서울특별시,350793,651712,1002505,3043743910,5700591720,8744335630,30.57,42.29,73
2019,4,10,20,3,42,서울특별시,219061,439685,658746,1874843460,3879436660,5754280120,41.29,38.86,80
2019,4,10,27,4,43,서울특별시,395118,336517,731635,3511732880,2905723210,6417456090,37.57,43.29,81
2019,4,11,03,5,44,서울특별시,427161,606846,1034007,3420308230,5150147630,8570455860,27.86,45,73
2019,4,11,10,1,45,서울특별시,439130,387335,826465,3851106860,3280947610,7132054470,22.57,53.86,76
2019,4,11,17,2,46,서울특별시,523498,261587,785085,4576806960,2141602872,6718409832,26.14,58.43,85
2019,4,11,24,3,47,서울특별시,308082,1074999,1383081,2626149410,9819053260,12445202670,26.86,59.29,86
2019,4,12,01,1,48,서울특별시,298729,1096882,1395611,2439701210,9432279723,11871980933,39.14,50.86,90
2019,4,12,08,1,49,서울특별시,159413,836150,995563,1305937020,7357585420,8663522440,37.43,48.57,86
2019,4,12,15,2,50,서울특별시,91122,846635,937757,734365860,7324398440,8058764300,34.57,51.14,86
2019,4,12,22,3,51,서울특별시,843537,432628,1276165,7448746040,3685596970,11134343010,33.71,54,88
2019,4,12,29,4,52,서울특별시,1128473,623183,1751656,9676409210,5168461910,14844871120,31.71,54.71,86
2019,1,01,06,1,1,세종특별자치시,4959,14681,19640,41977800,119881900,161859700,4.57,5.86,10
2019,1,01,13,2,2,세종특별자치시,11333,7167,18500,93019700,56994450,150014150,4.86,5.57,10
2019,1,01,20,3,3,세종특별자치시,10219,5735,15954,84717490,46153490,130870980,4.86,7.14,12
2019,1,01,27,4,4,세종특별자치시,21322,2611,23933,182282850,19809530,202092380,5.57,6.57,12
2019,1,02,03,5,5,세종특별자치시,30050,4993,35043,242312600,37189470,279502070,4.86,2.57,7
2019,1,02,10,1,6,세종특별자치시,33283,10616,43899,285893720,87815670,373709390,4,4.29,8
2019,1,02,17,2,7,세종특별자치시,13800,7968,21768,109897560,60686580,170584140,3.57,8.14,12
2019,1,02,24,3,8,세종특별자치시,14507,4667,19174,116969170,35206320,152175490,4.43,8.43,13
2019,1,03,03,4,9,세종특별자치시,16353,4004,20357,127138640,29758340,156896980,5.43,6.43,12
2019,1,03,10,1,10,세종특별자치시,3441,16655,20096,28912560,138486460,167399020,5.57,4.14,10
2019,1,03,17,2,11,세종특별자치시,1644,10361,12005,13309670,86505850,99815520,4.71,3.71,8
2019,1,03,24,3,12,세종특별자치시,8251,3987,12238,69972640,32668930,102641570,4.29,3.71,8
2019,1,03,31,4,13,세종특별자치시,5895,8744,14639,46677220,68846900,115524120,4,4.14,8
2019,2,04,07,1,14,세종특별자치시,3512,6518,10030,29014470,52858280,81872750,3.43,5.71,9
2019,2,04,14,2,15,세종특별자치시,3683,3671,7354,31776850,30173380,61950230,3.29,7.86,11
2019,2,04,21,3,16,세종특별자치시,3138,1706,4844,25889920,14046690,39936610,6,6.86,13
2019,2,04,28,4,17,세종특별자치시,2684,33984,36668,20359390,272717740,293077130,4.86,3,8
2019,2,05,05,1,18,세종특별자치시,5865,28175,34040,46668310,229641990,276310300,3.29,2.57,6
2019,2,05,12,2,19,세종특별자치시,6435,12988,19423,52700340,108450040,161150380,2.86,2.86,6
2019,2,05,19,3,20,세종특별자치시,11657,4549,16206,97867550,37829890,135697440,5,3.29,8
2019,2,05,26,4,21,세종특별자치시,8332,7650,15982,68976630,64194210,133170840,5,3.71,9
2019,2,06,02,5,22,세종특별자치시,22323,8999,31322,186037560,68108050,254145610,4.29,3.86,8
2019,2,06,09,1,23,세종특별자치시,20735,16204,36939,173842960,131466510,305309470,2.71,4.86,8
2019,2,06,16,2,24,세종특별자치시,6819,12516,19335,57585240,102903120,160488360,1.43,6.29,8
2019,2,06,23,3,25,세종특별자치시,6647,17231,23878,56181070,140570620,196751690,1.86,6,8
2019,2,06,30,4,26,세종특별자치시,3526,20813,24339,27881820,163137730,191019550,3.57,5.86,9
2019,3,07,07,1,27,세종특별자치시,1255,34591,35846,10051300,278349260,288400560,2.86,5.43,8
2019,3,07,14,2,28,세종특별자치시,1424,21043,22467,11314310,173440330,184754640,2.29,5.29,8
2019,3,07,21,3,29,세종특별자치시,984,22961,23945,6879500,189587140,196466640,2.57,6.57,9
2019,3,07,28,4,30,세종특별자치시,5770,18687,24457,46706130,151866920,198573050,2.57,6.14,9
2019,3,08,04,1,31,세종특별자치시,22623,15243,37866,178436330,115864870,294301200,3.86,4,8
2019,3,08,11,2,32,세종특별자치시,30769,5710,36479,253727250,43880020,297607270,5.43,3.71,9
2019,3,08,18,3,33,세종특별자치시,23529,12318,35847,193813330,101699480,295512810,6,4.57,11
2019,3,08,25,4,34,세종특별자치시,13581,5744,19325,112808730,48132670,160941400,5.14,3.86,9
2019,3,09,01,5,35,세종특별자치시,11939,4097,16036,91914200,31541070,123455270,5.43,6,11
2019,3,09,08,1,36,세종특별자치시,8843,3449,12292,70762780,28119080,98881860,5,4.43,9
2019,3,09,15,2,37,세종특별자치시,27199,1253,28452,230632790,10074720,240707510,6.71,3,10
2019,3,09,22,3,38,세종특별자치시,9487,3536,13023,77571610,29045540,106617150,6.43,2.29,9
2019,3,09,29,4,39,세종특별자치시,8049,2697,10746,62247210,20590580,82837790,5.71,5,11
2019,4,10,06,1,40,세종특별자치시,10257,13602,23859,82319520,110414480,192734000,5.14,4.29,9
2019,4,10,13,2,41,세종특별자치시,7128,10778,17906,57844580,87677660,145522240,4.29,5.43,10
2019,4,10,20,3,42,세종특별자치시,3629,7319,10948,30222440,60352600,90575040,4.71,5,10
2019,4,10,27,4,43,세종특별자치시,8104,5641,13745,68899620,46491300,115390920,4.43,6.43,11
2019,4,11,03,5,44,세종특별자치시,8186,12756,20942,64187580,100468000,164655580,2.29,7.29,10
2019,4,11,10,1,45,세종특별자치시,8535,7547,16082,71826660,61444480,133271140,2.57,7,10
2019,4,11,17,2,46,세종특별자치시,10100,3884,13984,84886720,31865700,116752420,4.29,6.71,11
2019,4,11,24,3,47,세종특별자치시,5800,31071,36871,47453040,247873860,295326900,4.57,3.86,8
2019,4,12,01,1,48,세종특별자치시,4712,30459,35171,35952460,235336960,271289420,3.57,3.43,7
2019,4,12,08,1,49,세종특별자치시,2526,20509,23035,19310700,165839020,185149720,4.14,5.14,9
2019,4,12,15,2,50,세종특별자치시,1923,19535,21458,14568460,156969320,171537780,3.57,7.57,11
2019,4,12,22,3,51,세종특별자치시,19421,8703,28124,160159240,68972220,229131460,2.71,5.71,8
2019,4,12,29,4,52,세종특별자치시,28146,9612,37758,226502920,77279760,303782680,3.71,4.43,8
2019,1,01,06,1,1,울산광역시,26978,63228,90206,231964350,542201600,774165950,4.86,6.43,11
2019,1,01,13,2,2,울산광역시,55573,27913,83486,470220800,229781900,700002700,6,9.14,15
2019,1,01,20,3,3,울산광역시,53129,22143,75272,445754010,189382610,635136620,6.14,11.43,18
2019,1,01,27,4,4,울산광역시,93204,9538,102742,805628670,77634720,883263390,6.43,12,18
2019,1,02,03,5,5,울산광역시,128102,15315,143417,1059326440,131998410,1191324850,6.29,5.43,12
2019,1,02,10,1,6,울산광역시,144044,40738,184782,1268710250,400838160,1669548410,5.86,6.29,12
2019,1,02,17,2,7,울산광역시,63200,24969,88169,517664630,220453090,738117720,5.14,9.14,14
2019,1,02,24,3,8,울산광역시,68485,19388,87873,553380210,156718810,710099020,5.57,12.29,18
2019,1,03,03,4,9,울산광역시,74797,12929,87726,591294820,97416840,688711660,6.43,14,20
2019,1,03,10,1,10,울산광역시,18805,58487,77292,158666260,542825740,701492000,6.29,8.57,15
2019,1,03,17,2,11,울산광역시,7993,40917,48910,66502740,366361240,432863980,6.57,8.43,15
2019,1,03,24,3,12,울산광역시,39770,16552,56322,346740770,145116630,491857400,7.57,6.71,14
2019,1,03,31,4,13,울산광역시,26813,31062,57875,214033130,254439220,468472350,5.86,9.57,15
2019,2,04,07,1,14,울산광역시,20615,25226,45841,174599450,215645450,390244900,4.29,10.71,15
2019,2,04,14,2,15,울산광역시,18468,18104,36572,153995260,156255110,310250370,3.71,13.43,17
2019,2,04,21,3,16,울산광역시,15927,10934,26861,128609160,94222140,222831300,7.57,15.71,23
2019,2,04,28,4,17,울산광역시,10762,116949,127711,81976630,1072167180,1154143810,6,9.43,15
2019,2,05,05,1,18,울산광역시,25734,102902,128636,205097810,916301640,1121399450,3.14,6.29,9
2019,2,05,12,2,19,울산광역시,34801,49253,84054,286091800,442719280,728811080,5.43,6.71,12
2019,2,05,19,3,20,울산광역시,55990,19457,75447,475460710,175682140,651142850,6.71,6,13
2019,2,05,26,4,21,울산광역시,42267,26489,68756,357511320,234724910,592236230,8.71,7.43,16
2019,2,06,02,5,22,울산광역시,84316,34225,118541,703084970,278015420,981100390,7.14,7.14,14
2019,2,06,09,1,23,울산광역시,73818,58676,132494,623464020,497940140,1121404160,4.71,7.57,12
2019,2,06,16,2,24,울산광역시,28687,49091,77778,239336770,422998650,662335420,3.43,9.86,13
2019,2,06,23,3,25,울산광역시,31685,58205,89890,270214110,505510020,775724130,4,10,14
2019,2,06,30,4,26,울산광역시,23986,70552,94538,192758320,586408440,779166760,4.14,11.71,16
2019,3,07,07,1,27,울산광역시,6646,116474,123120,53809470,1033107980,1086917450,4.29,8.86,13
2019,3,07,14,2,28,울산광역시,11236,83688,94924,91584320,712657980,804242300,5,7.86,13
2019,3,07,21,3,29,울산광역시,4603,82465,87068,36490860,733583440,770074300,4.57,9.57,14
2019,3,07,28,4,30,울산광역시,22831,57641,80472,186396950,497962300,684359250,4.57,8.57,13
2019,3,08,04,1,31,울산광역시,106005,50566,156571,867902430,393712410,1261614840,4.57,5.43,10
2019,3,08,11,2,32,울산광역시,145448,22950,168398,1213235060,176743380,1389978440,6.29,5.43,12
2019,3,08,18,3,33,울산광역시,92860,58612,151472,774045530,518771060,1292816590,8,7.14,15
2019,3,08,25,4,34,울산광역시,63837,29150,92987,531513420,257203790,788717210,10.29,7.29,18
2019,3,09,01,5,35,울산광역시,53795,23619,77414,423650760,193193940,616844700,10.14,10.86,21
2019,3,09,08,1,36,울산광역시,36314,18993,55307,293733390,159980580,453713970,11.71,10.57,22
2019,3,09,15,2,37,울산광역시,130831,5057,135888,1140739050,40283780,1181022830,9.29,6.43,16
2019,3,09,22,3,38,울산광역시,47086,10995,58081,385584500,99758410,485342910,8.57,6,15
2019,3,09,29,4,39,울산광역시,46288,8998,55286,365773060,71865110,437638170,8.86,8.57,17
2019,4,10,06,1,40,울산광역시,54386,41340,95726,449875840,367904870,817780710,7.57,8.14,16
2019,4,10,13,2,41,울산광역시,35258,38117,73375,287966700,321255820,609222520,7.29,7.86,15
2019,4,10,20,3,42,울산광역시,22238,30656,52894,183655040,254596280,438251320,10.43,9.57,20
2019,4,10,27,4,43,울산광역시,34158,26614,60772,285247040,211439340,496686380,8.43,13.14,22
2019,4,11,03,5,44,울산광역시,34513,45912,80425,270492860,378178480,648671340,5.29,11.29,17
2019,4,11,10,1,45,울산광역시,40753,27389,68142,345288380,225788560,571076940,4,9.14,13
2019,4,11,17,2,46,울산광역시,49326,14013,63339,417472900,113390920,530863820,5.14,9.86,15
2019,4,11,24,3,47,울산광역시,28642,97047,125689,234818680,827215140,1062033820,7.43,7.57,15
2019,4,12,01,1,48,울산광역시,26622,89356,115978,211291760,727845720,939137480,8.14,5.86,14
2019,4,12,08,1,49,울산광역시,15331,62931,78262,120250560,526279360,646529920,7.14,7.29,14
2019,4,12,15,2,50,울산광역시,8653,59771,68424,64096600,501065240,565161840,6.71,9.86,17
2019,4,12,22,3,51,울산광역시,94058,25015,119073,793063920,203883640,996947560,5.43,6,11
2019,4,12,29,4,52,울산광역시,125920,31070,156990,1042309600,250131820,1292441420,3.86,5.71,10
2019,1,01,06,1,1,인천광역시,56725,145703,202428,500221650,1236863350,1737085000,7.14,16.29,23
2019,1,01,13,2,2,인천광역시,117035,72738,189773,1010885200,588712880,1599598080,9.86,19.57,29
2019,1,01,20,3,3,인천광역시,114293,56117,170410,966099370,469627550,1435726920,9.43,21.43,31
2019,1,01,27,4,4,인천광역시,218304,26214,244518,1921342380,199055280,2120397660,8.71,22.71,31
2019,1,02,03,5,5,인천광역시,304860,38793,343653,2523282630,305857000,2829139630,10.86,16.86,28
2019,1,02,10,1,6,인천광역시,361961,105042,467003,3251344010,966622080,4217966090,9.43,14,23
2019,1,02,17,2,7,인천광역시,145703,65882,211585,1213611830,554144900,1767756730,7.86,17.71,26
2019,1,02,24,3,8,인천광역시,152313,48641,200954,1279814180,382480320,1662294500,6.57,23.71,30
2019,1,03,03,4,9,인천광역시,181580,28818,210398,1460065020,216573160,1676638180,8.86,25.14,34
2019,1,03,10,1,10,인천광역시,40056,168622,208678,343227590,1503748300,1846975890,8,19.71,28
2019,1,03,17,2,11,인천광역시,18744,110291,129035,157141660,973411510,1130553170,9,19.86,29
2019,1,03,24,3,12,인천광역시,94559,48484,143043,844557310,417622030,1262179340,10.71,19.57,30
2019,1,03,31,4,13,인천광역시,67926,93170,161096,555802040,762792110,1318594150,9.86,17.57,27
2019,2,04,07,1,14,인천광역시,47191,69343,116534,400715860,588974940,989690800,14.29,15.29,30
2019,2,04,14,2,15,인천광역시,38132,46910,85042,321690270,400034270,721724540,12.29,18.71,31
2019,2,04,21,3,16,인천광역시,33001,32215,65216,273155250,272353260,545508510,10.71,24.14,35
2019,2,04,28,4,17,인천광역시,26065,362814,388879,200559640,3115728610,3316288250,8.43,21.57,30
2019,2,05,05,1,18,인천광역시,55637,254712,310349,448701580,2228329490,2677031070,10.29,20.43,31
2019,2,05,12,2,19,인천광역시,76469,118940,195409,655965170,1052971810,1708936980,12.14,17.14,29
2019,2,05,19,3,20,인천광역시,135157,46235,181392,1183042810,400854990,1583897800,10,15,25
2019,2,05,26,4,21,인천광역시,104436,65658,170094,913191070,580698420,1493889490,12.71,15.57,28
2019,2,06,02,5,22,인천광역시,216336,91233,307569,1855598970,730176810,2585775780,13.86,17.29,31
2019,2,06,09,1,23,인천광역시,193946,144595,338541,1666088640,1244985620,2911074260,12.29,18,30
2019,2,06,16,2,24,인천광역시,69453,125588,195041,595004910,1087887870,1682892780,7.43,20.43,28
2019,2,06,23,3,25,인천광역시,73094,160002,233096,640345360,1377705270,2018050630,5.43,21.14,27
2019,2,06,30,4,26,인천광역시,51409,196972,248381,415557790,1629130290,2044688080,6.29,22.43,29
2019,3,07,07,1,27,인천광역시,14034,335803,349837,116498700,2888228820,3004727520,7.29,21.71,29
2019,3,07,14,2,28,인천광역시,22522,203715,226237,187551380,1739172270,1926723650,7.43,19.71,27
2019,3,07,21,3,29,인천광역시,9791,210829,220620,80332190,1848267740,1928599930,7.71,22.71,30
2019,3,07,28,4,30,인천광역시,48823,155601,204424,413561550,1325487780,1739049330,8,22.14,30
2019,3,08,04,1,31,인천광역시,248541,124239,372780,2048793490,969310700,3018104190,8.86,20,29
2019,3,08,11,2,32,인천광역시,292784,48546,341330,2524023280,375552320,2899575600,10.86,19.14,30
2019,3,08,18,3,33,인천광역시,211705,128240,339945,1823103350,1130505760,2953609110,12,16.29,28
2019,3,08,25,4,34,인천광역시,140438,63019,203457,1225061160,538679000,1763740160,15.43,21,36
2019,3,09,01,5,35,인천광역시,122732,52695,175427,987056670,419470960,1406527630,14.86,22.14,37
2019,3,09,08,1,36,인천광역시,71203,45183,116386,586460890,385466710,971927600,17.86,16.86,35
2019,3,09,15,2,37,인천광역시,313974,18179,332153,2815748000,147006680,2962754680,18,11.86,30
2019,3,09,22,3,38,인천광역시,109703,28496,138199,930486500,245478660,1175965160,15.29,13.14,28
2019,3,09,29,4,39,인천광역시,97888,24284,122172,790951710,189366960,980318670,14.57,17.14,32
2019,4,10,06,1,40,인천광역시,120296,124039,244335,1017629320,1064065420,2081694740,14.14,18.29,32
2019,4,10,13,2,41,인천광역시,76378,100756,177134,650001240,855328180,1505329420,13.57,15.43,29
2019,4,10,20,3,42,인천광역시,42781,72832,115613,359884200,624197280,984081480,18.29,19.57,38
2019,4,10,27,4,43,인천광역시,76025,57043,133068,650134140,477711560,1127845700,17.14,22.71,40
2019,4,11,03,5,44,인천광역시,77463,120383,197846,609858440,981281180,1591139620,10,23,33
2019,4,11,10,1,45,인천광역시,92283,68412,160695,797311900,575925560,1373237460,8.86,21,30
2019,4,11,17,2,46,인천광역시,110625,40894,151519,951171060,338347420,1289518480,10,23.29,33
2019,4,11,24,3,47,인천광역시,62797,255633,318430,530356620,2197536000,2727892620,11.86,19.57,31
2019,4,12,01,1,48,인천광역시,53322,237063,290385,430411300,1913033340,2343444640,13.14,15.14,28
2019,4,12,08,1,49,인천광역시,33057,150704,183761,266740920,1255673740,1522414660,14.43,15.71,30
2019,4,12,15,2,50,인천광역시,19266,148553,167819,146864940,1244675770,1391540710,15.57,19,35
2019,4,12,22,3,51,인천광역시,206949,63757,270706,1790397260,517020000,2307417260,12,18.57,31
2019,4,12,29,4,52,인천광역시,288171,79865,368036,2425522140,660343880,3085866020,9.14,17.86,27
2019,1,01,06,1,1,전라남도,31114,60243,91357,246777200,457698500,704475700,5.43,6.57,12
2019,1,01,13,2,2,전라남도,61003,27334,88337,469011500,200845850,669857350,6.29,6.71,13
2019,1,01,20,3,3,전라남도,59596,20994,80590,452977750,158239600,611217350,6,8,14
2019,1,01,27,4,4,전라남도,109875,8076,117951,858438800,58226900,916665700,6.14,9.57,16
2019,1,02,03,5,5,전라남도,154847,14446,169293,1172825610,100655950,1273481560,8.71,6.14,15
2019,1,02,10,1,6,전라남도,186837,41272,228109,1501090160,322060120,1823150280,4.86,4.57,9
2019,1,02,17,2,7,전라남도,70867,24402,95269,529175150,180279840,709454990,5.57,7.86,13
2019,1,02,24,3,8,전라남도,72046,13777,85823,541555230,98883690,640438920,5.86,11.29,17
2019,1,03,03,4,9,전라남도,77871,8717,86588,574607340,62243630,636850970,6.57,11.86,18
2019,1,03,10,1,10,전라남도,19561,57698,77259,150875270,454462240,605337510,6.29,6.14,12
2019,1,03,17,2,11,전라남도,10511,37151,47662,78632380,289091820,367724200,7.29,6.57,14
2019,1,03,24,3,12,전라남도,43137,14714,57851,343876730,113051620,456928350,7.14,6.43,14
2019,1,03,31,4,13,전라남도,28384,26679,55063,213776990,199074120,412851110,5.14,8.43,14
2019,2,04,07,1,14,전라남도,23690,21421,45111,183610570,167650200,351260770,6.14,8,14
2019,2,04,14,2,15,전라남도,23228,15115,38343,172818790,119584350,292403140,4.86,10.29,15
2019,2,04,21,3,16,전라남도,20429,9074,29503,151533540,69473270,221006810,7.71,12.43,20
2019,2,04,28,4,17,전라남도,16861,130229,147090,116138940,997827880,1113966820,8,6.71,15
2019,2,05,05,1,18,전라남도,30686,94132,124818,228462340,720767390,949229730,5.57,4.43,10
2019,2,05,12,2,19,전라남도,40873,43750,84623,314996090,335389530,650385620,4.71,5.57,10
2019,2,05,19,3,20,전라남도,65468,16673,82141,522982560,127288520,650271080,5.71,5.57,11
2019,2,05,26,4,21,전라남도,45631,22173,67804,359561900,172207940,531769840,8.29,7.43,16
2019,2,06,02,5,22,전라남도,88320,31458,119778,698136400,229631400,927767800,8,6.57,15
2019,2,06,09,1,23,전라남도,83550,59193,142743,648696880,453624480,1102321360,5.29,6.43,12
2019,2,06,16,2,24,전라남도,29497,44570,74067,228779820,346550970,575330790,4.14,10.86,15
2019,2,06,23,3,25,전라남도,46351,50321,96672,367220140,389218980,756439120,3.86,10.43,14
2019,2,06,30,4,26,전라남도,35841,59910,95751,272891720,460271890,733163610,3.86,9.14,13
2019,3,07,07,1,27,전라남도,11587,127299,138886,87878320,982460890,1070339210,4,8.71,13
2019,3,07,14,2,28,전라남도,12626,76188,88814,94003910,578196150,672200060,5.71,7.86,14
2019,3,07,21,3,29,전라남도,5018,86764,91782,35650280,671378720,707029000,5.86,11.29,17
2019,3,07,28,4,30,전라남도,28296,55652,83948,212019700,422291510,634311210,4.29,11.86,16
2019,3,08,04,1,31,전라남도,115480,44536,160016,866873790,320743740,1187617530,4.14,9.43,14
2019,3,08,11,2,32,전라남도,146319,16582,162901,1143859960,118379190,1262239150,6,7.29,13
2019,3,08,18,3,33,전라남도,122134,55795,177929,954828440,439604650,1394433090,7.57,9,17
2019,3,08,25,4,34,전라남도,74071,28453,102524,582211940,220427330,802639270,9.57,8.29,18
2019,3,09,01,5,35,전라남도,60801,18120,78921,452509120,137595300,590104420,9.57,8.71,18
2019,3,09,08,1,36,전라남도,37720,17169,54889,288192980,137205640,425398620,8.71,7.86,17
2019,3,09,15,2,37,전라남도,158633,5305,163938,1309874020,40871080,1350745100,10.43,5.14,16
2019,3,09,22,3,38,전라남도,56152,10014,66166,432893100,81051090,513944190,9.14,7.14,16
2019,3,09,29,4,39,전라남도,49383,6110,55493,369813060,46355500,416168560,9.43,7.71,17
2019,4,10,06,1,40,전라남도,57065,38004,95069,445109980,301425460,746535440,8,7.29,15
2019,4,10,13,2,41,전라남도,35484,34430,69914,272222340,270454240,542676580,6.86,8.57,15
2019,4,10,20,3,42,전라남도,21509,30559,52068,162835600,232092520,394928120,11.57,8.43,20
2019,4,10,27,4,43,전라남도,32058,23868,55926,250152860,178248600,428401460,9,11.14,20
2019,4,11,03,5,44,전라남도,32084,42067,74151,238263260,318508820,556772080,4.14,12.57,17
2019,4,11,10,1,45,전라남도,42413,27189,69602,337071540,207428060,544499600,4,11.29,15
2019,4,11,17,2,46,전라남도,53622,14192,67814,422073320,109402080,531475400,5.29,10.29,16
2019,4,11,24,3,47,전라남도,31912,105871,137783,243750060,808025700,1051775760,8.71,8.43,17
2019,4,12,01,1,48,전라남도,25064,89349,114413,190730920,648420820,839151740,8.29,5.29,14
2019,4,12,08,1,49,전라남도,18116,67327,85443,131860300,496109560,627969860,8.14,6.57,15
2019,4,12,15,2,50,전라남도,12908,65059,77967,88032720,478455340,566488060,6.86,9.71,17
2019,4,12,22,3,51,전라남도,104102,24658,128760,815845220,175057240,990902460,6.14,7,13
2019,4,12,29,4,52,전라남도,150725,25833,176558,1171943080,192295360,1364238440,5.14,4.86,10
2019,1,01,06,1,1,전라북도,35235,79504,114739,290652200,642786150,933438350,6.86,11,18
2019,1,01,13,2,2,전라북도,73341,38218,111559,596285400,295558550,891843950,6.86,13.14,20
2019,1,01,20,3,3,전라북도,69065,26733,95798,554062590,209914720,763977310,7.43,15,22
2019,1,01,27,4,4,전라북도,132371,11348,143719,1097480990,83175710,1180656700,8,17.57,26
2019,1,02,03,5,5,전라북도,189847,22022,211869,1503612180,165957430,1669569610,8.86,12,21
2019,1,02,10,1,6,전라북도,226224,59401,285625,1914659800,519416760,2434076560,7.71,9,17
2019,1,02,17,2,7,전라북도,87177,32642,119819,693152000,262362820,955514820,8,11.86,20
2019,1,02,24,3,8,전라북도,89142,21303,110445,711298740,159458390,870757130,7.43,16.86,24
2019,1,03,03,4,9,전라북도,103638,13904,117542,794029250,97483560,891512810,9.29,18,27
2019,1,03,10,1,10,전라북도,26348,89550,115898,206667080,762707010,969374090,8,17,25
2019,1,03,17,2,11,전라북도,11941,56289,68230,91697790,474865280,566563070,9.29,16,25
2019,1,03,24,3,12,전라북도,57818,23358,81176,482776020,190960490,673736510,10.14,13.14,23
2019,1,03,31,4,13,전라북도,40344,45991,86335,312402970,355837930,668240900,10,15.57,26
2019,2,04,07,1,14,전라북도,28257,33728,61985,224657170,261949570,486606740,8.86,15,24
2019,2,04,14,2,15,전라북도,24176,23621,47797,192738070,191316630,384054700,8,16.43,24
2019,2,04,21,3,16,전라북도,21272,14519,35791,165084050,117578150,282662200,12,19.71,32
2019,2,04,28,4,17,전라북도,16906,194992,211898,123349960,1610902320,1734252280,9.86,14.29,24
2019,2,05,05,1,18,전라북도,35798,134709,170507,272490850,1137980460,1410471310,8.71,10,19
2019,2,05,12,2,19,전라북도,47133,60989,108122,374302440,517580060,891882500,10.29,9.86,20
2019,2,05,19,3,20,전라북도,80592,24479,105071,667330150,204482260,871812410,9.57,9.57,19
2019,2,05,26,4,21,전라북도,60497,40811,101308,497075660,294817910,791893570,10.29,13.29,24
2019,2,06,02,5,22,전라북도,127408,49886,177294,1034545240,382523260,1417068500,10.43,14.57,25
2019,2,06,09,1,23,전라북도,113744,81843,195587,916608660,661957000,1578565660,7.57,15.86,23
2019,2,06,16,2,24,전라북도,41799,66455,108254,328928330,542718610,871646940,6.14,17.57,24
2019,2,06,23,3,25,전라북도,47181,83837,131018,387941290,679391580,1067332870,5.43,18.71,24
2019,2,06,30,4,26,전라북도,34338,102801,137139,264938230,800689770,1065628000,4.43,17.29,22
2019,3,07,07,1,27,전라북도,9691,187791,197482,74611370,1525604970,1600216340,4.29,13.71,18
2019,3,07,14,2,28,전라북도,16430,111341,127771,126544620,876102940,1002647560,7.57,15.43,23
2019,3,07,21,3,29,전라북도,6804,123355,130159,51154930,1007898870,1059053800,9.14,16.71,26
2019,3,07,28,4,30,전라북도,35592,82662,118254,274384690,657761640,932146330,9.43,18,27
2019,3,08,04,1,31,전라북도,158357,64866,223223,1225676360,471475080,1697151440,7.57,15.86,23
2019,3,08,11,2,32,전라북도,193240,37199,230439,1555636590,202905370,1758541960,8.57,12.71,21
2019,3,08,18,3,33,전라북도,146481,91701,238182,1172807380,661293300,1834100680,10.71,12.57,23
2019,3,08,25,4,34,전라북도,93334,38245,131579,749807560,310875330,1060682890,11.71,14.14,26
2019,3,09,01,5,35,전라북도,75927,29826,105753,574090990,218648720,792739710,11.57,16.43,28
2019,3,09,08,1,36,전라북도,47254,26993,74247,363434300,201808390,565242690,14.71,18,33
2019,3,09,15,2,37,전라북도,202847,8193,211040,1707617380,63202580,1770819960,13.57,11.14,25
2019,3,09,22,3,38,전라북도,68944,15215,84159,551824990,124784600,676609590,12,11.29,23
2019,3,09,29,4,39,전라북도,56947,16771,73718,435432750,86068030,521500780,11.43,13,24
2019,4,10,06,1,40,전라북도,75120,67317,142437,598786760,497292640,1096079400,11.86,15.57,27
2019,4,10,13,2,41,전라북도,46680,55488,102168,371543960,421795580,793339540,11.71,13.14,25
2019,4,10,20,3,42,전라북도,25041,40006,65047,199288380,323248360,522536740,14.71,13.43,28
2019,4,10,27,4,43,전라북도,41162,31696,72858,335358580,248367060,583725640,12.86,18.57,31
2019,4,11,03,5,44,전라북도,44531,63515,108046,334560140,487970720,822530860,7.43,18,25
2019,4,11,10,1,45,전라북도,55342,35447,90789,456021080,277645000,733666080,5,16,21
2019,4,11,17,2,46,전라북도,69241,20372,89613,560221380,156649960,716871340,7.57,18,26
2019,4,11,24,3,47,전라북도,39938,142600,182538,316097580,1136363480,1452461060,11.86,16.86,29
2019,4,12,01,1,48,전라북도,32290,129625,161915,243399920,974032300,1217432220,13.14,13.43,27
2019,4,12,08,1,49,전라북도,21640,97052,118692,161703020,754742600,916445620,15.29,15.29,31
2019,4,12,15,2,50,전라북도,13499,90384,103883,98139320,705397840,803537160,14.29,17.43,32
2019,4,12,22,3,51,전라북도,133974,35849,169823,1080582040,257506180,1338088220,13.14,13.71,27
2019,4,12,29,4,52,전라북도,185573,41344,226917,1471073220,315998860,1787072080,10,15.14,25
2019,1,01,06,1,1,제주특별자치도,12543,30394,42937,107704350,253081900,360786250,6.14,6.43,13
2019,1,01,13,2,2,제주특별자치도,27574,14783,42357,231036900,116521750,347558650,7,6.43,13
2019,1,01,20,3,3,제주특별자치도,26527,10779,37306,219885950,87494300,307380250,8.86,8,17
2019,1,01,27,4,4,제주특별자치도,44117,3787,47904,380106830,29538300,409645130,7.43,9.57,17
2019,1,02,03,5,5,제주특별자치도,65262,6514,71776,536464490,50083450,586547940,7.43,4.29,12
2019,1,02,10,1,6,제주특별자치도,71313,17469,88782,625274020,148199320,773473340,6.57,3.71,10
2019,1,02,17,2,7,제주특별자치도,33376,12462,45838,277407160,101628380,379035540,6.14,7,13
2019,1,02,24,3,8,제주특별자치도,34216,6643,40859,287443910,51845450,339289360,5.43,9.43,15
2019,1,03,03,4,9,제주특별자치도,37952,4032,41984,304483590,31286880,335770470,7.29,8,15
2019,1,03,10,1,10,제주특별자치도,11394,32686,44080,94637930,277715010,372352940,7.71,4.43,12
2019,1,03,17,2,11,제주특별자치도,4873,20782,25655,41116380,176817090,217933470,8.29,4.57,13
2019,1,03,24,3,12,제주특별자치도,20464,9694,30158,177540240,81420290,258960530,6.14,5.71,12
2019,1,03,31,4,13,제주특별자치도,14354,14667,29021,115602430,119183860,234786290,6.14,6.14,12
2019,2,04,07,1,14,제주특별자치도,11341,12823,24164,95617980,108711690,204329670,4.71,6.71,11
2019,2,04,14,2,15,제주특별자치도,10049,8919,18968,84673730,75727520,160401250,4.57,9.43,14
2019,2,04,21,3,16,제주특별자치도,9069,4850,13919,77251860,40192700,117444560,7.71,11,19
2019,2,04,28,4,17,제주특별자치도,7032,66313,73345,55527680,549000970,604528650,6.71,5.57,12
2019,2,05,05,1,18,제주특별자치도,11793,53240,65033,94441240,443412980,537854220,5.43,3.43,9
2019,2,05,12,2,19,제주특별자치도,17048,26362,43410,142923240,221525320,364448560,5.29,3.71,9
2019,2,05,19,3,20,제주특별자치도,30370,10340,40710,262195820,86363330,348559150,7.14,4.14,11
2019,2,05,26,4,21,제주특별자치도,22271,11618,33889,191324980,98161930,289486910,8.29,5.29,14
2019,2,06,02,5,22,제주특별자치도,44363,17707,62070,372791360,138300050,511091410,7.71,5.86,14
2019,2,06,09,1,23,제주특별자치도,40783,29251,70034,344576480,244301280,588877760,5.57,6.86,12
2019,2,06,16,2,24,제주특별자치도,16361,25101,41462,138570230,209105870,347676100,3,9.43,12
2019,2,06,23,3,25,제주특별자치도,16574,31339,47913,143209780,263477220,406687000,3.43,8,11
2019,2,06,30,4,26,제주특별자치도,12527,40043,52570,102012220,326876610,428888830,4.71,7.29,12
2019,3,07,07,1,27,제주특별자치도,4127,61721,65848,33665240,519475900,553141140,3.43,6.14,10
2019,3,07,14,2,28,제주특별자치도,5713,50284,55997,47667680,417103700,464771380,4.57,6.14,11
2019,3,07,21,3,29,제주특별자치도,1897,52393,54290,15165780,438268340,453434120,4.57,8.57,13
2019,3,07,28,4,30,제주특별자치도,11263,32533,43796,95229530,271878280,367107810,2.86,7.71,11
2019,3,08,04,1,31,제주특별자치도,46599,24128,70727,380118140,188443770,568561910,3.57,6.71,10
2019,3,08,11,2,32,제주특별자치도,66860,8753,75613,567194520,69516210,636710730,6.29,4.71,11
2019,3,08,18,3,33,제주특별자치도,53653,22664,76317,458087240,197344920,655432160,7.71,6,14
2019,3,08,25,4,34,제주특별자치도,34960,13891,48851,299703580,119112660,418816240,8.57,8.43,17
2019,3,09,01,5,35,제주특별자치도,30624,10206,40830,250418800,83721470,334140270,7.57,8,16
2019,3,09,08,1,36,제주특별자치도,19561,8134,27695,163215120,69131780,232346900,9.71,8.14,18
2019,3,09,15,2,37,제주특별자치도,61693,2344,64037,547445220,19431200,566876420,8.86,4.43,13
2019,3,09,22,3,38,제주특별자치도,25199,5673,30872,216167580,49642200,265809780,8.43,3.29,12
2019,3,09,29,4,39,제주특별자치도,23702,4394,28096,195505260,35224030,230729290,9.43,5.71,15
2019,4,10,06,1,40,제주특별자치도,26800,22094,48894,230164080,191142200,421306280,7.71,5.57,13
2019,4,10,13,2,41,제주특별자치도,15087,18927,34014,127917720,163125420,291043140,6.57,7.71,14
2019,4,10,20,3,42,제주특별자치도,10526,17862,28388,91298760,153206140,244504900,7.29,8.29,16
2019,4,10,27,4,43,제주특별자치도,17763,12856,30619,154081100,107849320,261930420,5.29,7.57,13
2019,4,11,03,5,44,제주특별자치도,16923,21554,38477,138637420,174128440,312765860,2.71,9.29,12
2019,4,11,10,1,45,제주특별자치도,20104,14245,34349,174247520,118062340,292309860,2.71,8.14,11
2019,4,11,17,2,46,제주특별자치도,25838,7048,32886,221592740,58481060,280073800,5.43,7.71,13
2019,4,11,24,3,47,제주특별자치도,14624,53167,67791,120574440,440910040,561484480,6.14,6,12
2019,4,12,01,1,48,제주특별자치도,12288,52393,64681,99938920,417548280,517487200,7,5.57,13
2019,4,12,08,1,49,제주특별자치도,7610,30487,38097,62617000,253236500,315853500,6.43,6,12
2019,4,12,15,2,50,제주특별자치도,4345,29868,34213,34506300,247656500,282162800,6.71,9.29,16
2019,4,12,22,3,51,제주특별자치도,48426,14298,62724,406812260,113386180,520198440,4,6.14,10
2019,4,12,29,4,52,제주특별자치도,65507,15875,81382,541328100,129174400,670502500,3.57,4.43,8
2019,1,01,06,1,1,충청남도,38621,92182,130803,321219350,746790650,1068010000,7.43,9,16
2019,1,01,13,2,2,충청남도,83127,47104,130231,675977400,363400100,1039377500,7.43,10.71,18
2019,1,01,20,3,3,충청남도,77812,34518,112330,630204570,275272300,905476870,8.14,12,20
2019,1,01,27,4,4,충청남도,145577,14680,160257,1214543570,109287830,1323831400,9.43,14.29,24
2019,1,02,03,5,5,충청남도,198574,25443,224017,1586917140,188210340,1775127480,11.14,9.57,21
2019,1,02,10,1,6,충청남도,222999,65374,288373,1896985630,537471900,2434457530,8,9.43,17
2019,1,02,17,2,7,충청남도,93511,42837,136348,746875060,332198500,1079073560,7,11.71,19
2019,1,02,24,3,8,충청남도,89386,25277,114663,721151400,191752720,912904120,8.29,14.14,22
2019,1,03,03,4,9,충청남도,107900,17605,125505,856607000,130097440,986704440,8.43,14.29,23
2019,1,03,10,1,10,충청남도,28958,101145,130103,240145340,854187170,1094332510,8.43,12,20
2019,1,03,17,2,11,충청남도,12397,66829,79226,100977650,563301980,664279630,9.86,12.14,22
2019,1,03,24,3,12,충청남도,61654,29945,91599,528497300,237445930,765943230,9.86,9.43,19
2019,1,03,31,4,13,충청남도,43390,55196,98586,348547040,430748570,779295610,10,14.71,25
2019,2,04,07,1,14,충청남도,30384,42047,72431,251254210,341126870,592381080,7.29,14,21
2019,2,04,14,2,15,충청남도,24000,27607,51607,198431340,227609510,426040850,6.43,16.57,23
2019,2,04,21,3,16,충청남도,22724,18401,41125,182208150,148029900,330238050,11.57,19.43,31
2019,2,04,28,4,17,충청남도,19673,204978,224651,150994190,1694458630,1845452820,12.71,11.86,25
2019,2,05,05,1,18,충청남도,37579,157360,194939,297961740,1311507230,1609468970,7.57,8.43,16
2019,2,05,12,2,19,충청남도,53222,70494,123716,445107110,595258490,1040365600,7,9.29,16
2019,2,05,19,3,20,충청남도,86833,28388,115221,743342410,234231480,977573890,8.43,8.14,17
2019,2,05,26,4,21,충청남도,68606,39142,107748,589193940,322366340,911560280,10.86,9.29,20
2019,2,06,02,5,22,충청남도,128613,55022,183635,1086080530,420147860,1506228390,10.29,10.43,21
2019,2,06,09,1,23,충청남도,114089,91426,205515,966087870,759891740,1725979610,7.57,12.57,20
2019,2,06,16,2,24,충청남도,40107,75984,116091,338307000,646937850,985244850,6.86,16.14,23
2019,2,06,23,3,25,충청남도,48656,93223,141879,416223090,787216480,1203439570,6.57,13.14,20
2019,2,06,30,4,26,충청남도,34078,112498,146576,273477410,914251310,1187728720,7,11.86,19
2019,3,07,07,1,27,충청남도,8806,206349,215155,70299140,1700756510,1771055650,8,12.29,20
2019,3,07,14,2,28,충청남도,16742,114294,131036,129255030,956787700,1086042730,9.43,12.86,22
2019,3,07,21,3,29,충청남도,6957,130859,137816,54072080,1100490260,1154562340,7.86,16.71,25
2019,3,07,28,4,30,충청남도,37665,94756,132421,306671020,785659840,1092330860,6.71,16.71,23
2019,3,08,04,1,31,충청남도,155515,75775,231290,1255926250,587494740,1843420990,5.71,12.86,19
2019,3,08,11,2,32,충청남도,201786,39403,241189,1689439850,271929660,1961369510,8.71,12.43,21
2019,3,08,18,3,33,충청남도,145850,92790,238640,1227288530,746492560,1973781090,10.86,10,21
2019,3,08,25,4,34,충청남도,93603,45327,138930,791964160,377016590,1168980750,11.57,14.71,26
2019,3,09,01,5,35,충청남도,80440,35233,115673,646604160,259618010,906222170,12,17.71,30
2019,3,09,08,1,36,충청남도,52848,30581,83429,435653290,247213120,682866410,14,17.57,32
2019,3,09,15,2,37,충청남도,205043,7080,212123,1791981020,58576800,1850557820,11.71,12.57,24
2019,3,09,22,3,38,충청남도,79908,17426,97334,667789900,149038470,816828370,12.14,11.14,23
2019,3,09,29,4,39,충청남도,61046,17539,78585,488058000,102539780,590597780,12.29,12.14,24
2019,4,10,06,1,40,충청남도,83121,76967,160088,686066220,593182710,1279248930,12,11.29,23
2019,4,10,13,2,41,충청남도,51375,65756,117131,428233140,512452250,940685390,10.57,11.86,22
2019,4,10,20,3,42,충청남도,31251,46741,77992,240399850,393487710,633887560,13.43,15.71,29
2019,4,10,27,4,43,충청남도,44858,35662,80520,383998620,298344080,682342700,12.29,17.57,30
2019,4,11,03,5,44,충청남도,44574,72600,117174,355605620,578238520,933844140,7.86,16.43,24
2019,4,11,10,1,45,충청남도,61245,45817,107062,516783960,364440830,881224790,6.71,19.14,26
2019,4,11,17,2,46,충청남도,72219,28115,100334,618222940,207609390,825832330,7.14,18.43,26
2019,4,11,24,3,47,충청남도,40372,163395,203767,338375450,1344479650,1682855100,9.71,15.71,25
2019,4,12,01,1,48,충청남도,35161,152857,188018,279022790,1213596070,1492618860,12.57,11.86,24
2019,4,12,08,1,49,충청남도,22516,97387,119903,179692050,800845590,980537640,12.71,12.14,25
2019,4,12,15,2,50,충청남도,13830,99230,113060,103187060,819555300,922742360,12.29,16.29,29
2019,4,12,22,3,51,충청남도,142614,36549,179163,1199457990,295581390,1495039380,9.43,14.71,24
2019,4,12,29,4,52,충청남도,186228,47222,233450,1539739290,383850420,1923589710,10,13.71,24
2019,1,01,06,1,1,충청북도,32578,68786,101364,275383700,568786250,844169950,5.57,10.29,16
2019,1,01,13,2,2,충청북도,65989,32491,98480,551894590,261659040,813553630,6.57,13.14,20
2019,1,01,20,3,3,충청북도,61691,25863,87554,513425460,209248980,722674440,6.57,14,21
2019,1,01,27,4,4,충청북도,119456,10705,130161,1019941560,82753630,1102695190,7.29,14.71,22
2019,1,02,03,5,5,충청북도,166891,20589,187480,1342080950,156282120,1498363070,8.71,9.14,18
2019,1,02,10,1,6,충청북도,193077,52771,245848,1682570060,449561040,2132131100,6.43,8.14,15
2019,1,02,17,2,7,충청북도,76882,32081,108963,626372230,255600870,881973100,5.29,11.71,17
2019,1,02,24,3,8,충청북도,80317,20106,100423,658970470,155876180,814846650,6.14,16.29,22
2019,1,03,03,4,9,충청북도,93819,12051,105870,735788140,91029870,826818010,8.14,17.86,26
2019,1,03,10,1,10,충청북도,23563,78754,102317,193394650,666061630,859456280,7.29,12.29,20
2019,1,03,17,2,11,충청북도,11076,50726,61802,89891460,432711960,522603420,7.86,11.14,19
2019,1,03,24,3,12,충청북도,51491,21631,73122,443248550,180118680,623367230,7.29,11.71,19
2019,1,03,31,4,13,충청북도,35757,42171,77928,286790950,337709050,624500000,7.57,12,20
2019,2,04,07,1,14,충청북도,25244,30648,55892,208726900,253244110,461971010,7.71,11.57,19
2019,2,04,14,2,15,충청북도,22133,22353,44486,183105830,187884200,370990030,5.14,15,20
2019,2,04,21,3,16,충청북도,18945,14213,33158,153287160,119377020,272664180,7.71,18.14,26
2019,2,04,28,4,17,충청북도,16425,189909,206334,123040680,1539299180,1662339860,7.43,16,23
2019,2,05,05,1,18,충청북도,34279,116357,150636,275119340,955132550,1230251890,6.14,12.14,18
2019,2,05,12,2,19,충청북도,46131,54016,100147,383950370,448581440,832531810,6.14,10,16
2019,2,05,19,3,20,충청북도,74715,19307,94022,636947000,157402850,794349850,6.29,10,16
2019,2,05,26,4,21,충청북도,56725,30750,87475,479576400,257618160,737194560,9.29,11.29,21
2019,2,06,02,5,22,충청북도,114338,45745,160083,954415590,358164930,1312580520,10.29,9.57,20
2019,2,06,09,1,23,충청북도,98584,75627,174211,826733820,622665590,1449399410,8.29,9.71,18
2019,2,06,16,2,24,충청북도,34832,60084,94916,290868340,505758290,796626630,6,13.86,20
2019,2,06,23,3,25,충청북도,41525,76601,118126,349033280,640342660,989375940,5.57,16.43,22
2019,2,06,30,4,26,충청북도,29022,92338,121360,229756790,748633040,978389830,4.43,14.29,19
2019,3,07,07,1,27,충청북도,8402,181025,189427,68713230,1488199110,1556912340,4.71,11.71,16
2019,3,07,14,2,28,충청북도,13967,89771,103738,114921700,741361530,856283230,6.29,11.29,18
2019,3,07,21,3,29,충청북도,6096,109102,115198,47478480,906930210,954408690,7.29,14.43,22
2019,3,07,28,4,30,충청북도,31787,79117,110904,257581040,637951210,895532250,7.43,13.14,21
2019,3,08,04,1,31,충청북도,141501,57495,198996,1120978410,436446790,1557425200,6.57,11.14,18
2019,3,08,11,2,32,충청북도,166983,23381,190364,1385720460,178737230,1564457690,9,8.43,17
2019,3,08,18,3,33,충청북도,125320,68324,193644,1036326730,572960340,1609287070,10,8.71,19
2019,3,08,25,4,34,충청북도,80149,31968,112117,663119860,265541890,928661750,12.29,10.29,23
2019,3,09,01,5,35,충청북도,68281,23417,91698,529603420,183904920,713508340,10.43,10.86,21
2019,3,09,08,1,36,충청북도,44326,23036,67362,355409170,192607520,548016690,13.29,11.43,25
2019,3,09,15,2,37,충청북도,177380,8279,185659,1537054860,66495000,1603549860,14.29,7.86,22
2019,3,09,22,3,38,충청북도,62565,16366,78931,511752320,134728680,646481000,13.86,9.43,23
2019,3,09,29,4,39,충청북도,54728,10974,65702,423649510,83076430,506725940,13.14,15,28
2019,4,10,06,1,40,충청북도,66990,58065,125055,546621350,478742970,1025364320,13.14,11.71,25
2019,4,10,13,2,41,충청북도,42789,47792,90581,347948340,389946820,737895160,13.29,10.57,24
2019,4,10,20,3,42,충청북도,23283,35969,59252,189894100,294383780,484277880,15.43,10.71,26
2019,4,10,27,4,43,충청북도,37540,30570,68110,307804080,241947600,549751680,12.57,14.29,27
2019,4,11,03,5,44,충청북도,39093,59759,98852,299480020,464157120,763637140,7.14,17.29,24
2019,4,11,10,1,45,충청북도,50946,32906,83852,423315340,265979340,689294680,5.71,16.43,22
2019,4,11,17,2,46,충청북도,60291,18851,79142,497853380,150059000,647912380,6,16,22
2019,4,11,24,3,47,충청북도,36382,141303,177685,292842820,1138639920,1431482740,10.14,13.57,24
2019,4,12,01,1,48,충청북도,31521,123112,154633,242597020,942311620,1184908640,11,9.86,21
2019,4,12,08,1,49,충청북도,20081,75639,95720,155070360,603165640,758236000,9.43,10,19
2019,4,12,15,2,50,충청북도,11728,80404,92132,87413200,645509980,732923180,8.43,15,23
2019,4,12,22,3,51,충청북도,124371,32716,157087,1019899580,250293140,1270192720,6.86,12.57,19
2019,4,12,29,4,52,충청북도,174619,40141,214760,1407837340,320565740,1728403080,5.29,11.86,17
2020,1,01,05,1,1,강원도,97226,31588,128814,771515740,254433501,1025949241,6.57,13.86,20
2020,1,01,12,2,2,강원도,33103,40683,73786,257444900,322015600,579460500,6.14,14,20
2020,1,01,19,3,3,강원도,33238,28457,61695,263366690,221885340,485252030,7.43,14.57,22
2020,1,01,26,4,4,강원도,117111,13466,130577,972798100,101612580,1074410680,7.86,13.29,21
2020,1,02,02,5,5,강원도,80376,8961,89337,625629620,63765580,689395200,9.29,15.57,25
2020,1,02,09,1,6,강원도,38170,8893,47063,306555360,71519320,378074680,8.29,11,19
2020,1,02,16,2,7,강원도,47747,17703,65450,377906260,137845440,515751700,7.29,11.43,19
2020,1,02,23,3,8,강원도,26587,15694,42281,210926600,122140220,333066820,7.29,12.57,20
2020,1,03,01,4,9,강원도,6625,10624,17249,51354320,82312520,133666840,5.29,13,18
2020,1,03,08,1,10,강원도,2422,7347,9769,19762040,59618060,79380100,5.29,18.14,23
2020,1,03,15,2,11,강원도,1050,6696,7746,8193400,54078440,62271840,6.14,26.57,33
2020,1,03,22,3,12,강원도,871,4733,5604,5901720,38243900,44145620,5.86,24.29,30
2020,1,03,29,4,13,강원도,727,4057,4784,5173020,31837180,37010200,6.43,23.57,30
2020,2,04,05,1,14,강원도,383,2653,3036,2552000,22466020,25018020,7.86,23.14,31
2020,2,04,12,2,15,강원도,121,2113,2234,816500,18294880,19111380,5,22.57,28
2020,2,04,19,3,16,강원도,688,2369,3057,6112500,18505920,24618420,4,22.86,27
2020,2,04,26,4,17,강원도,1627,2210,3837,9058840,15225580,24284420,3.71,23,27
2020,2,05,03,5,18,강원도,1741,4890,6631,14533500,36700840,51234340,5.71,18.71,24
2020,2,05,10,1,19,강원도,1625,5606,7231,12990900,44759800,57750700,5.71,17.14,23
2020,2,05,17,2,20,강원도,718,3613,4331,5495560,31104420,36599980,6.29,17.43,24
2020,2,05,24,3,21,강원도,692,4536,5228,4811500,35988180,40799680,4.29,23.71,28
2020,2,05,31,4,22,강원도,570,4750,5320,4004260,35251200,39255460,7.86,22,30
2020,2,06,07,1,23,강원도,6352,3763,10115,56362480,28960380,85322860,7.29,17.29,25
2020,2,06,14,2,24,강원도,10354,3216,13570,93060960,23934860,116995820,7.57,15,23
2020,2,06,21,3,25,강원도,9715,5209,14924,85180460,39968900,125149360,8,14.57,23
2020,2,06,28,4,26,강원도,26425,3677,30102,219608880,27781060,247389940,6.14,11.86,18
2020,3,07,05,1,27,강원도,14507,2656,17163,125851680,21138960,146990640,7,14.57,22
2020,3,07,12,2,28,강원도,7091,3604,10695,61439460,30184600,91624060,8.29,17.43,26
2020,3,07,19,3,29,강원도,39576,1822,41398,344281040,15262080,359543120,7.57,12,20
2020,3,07,26,4,30,강원도,26021,3293,29314,221626460,24061640,245688100,6.29,14.14,20
2020,3,08,02,5,31,강원도,34965,2732,37697,285460740,19893980,305354720,5.71,15,21
2020,3,08,09,1,32,강원도,60792,3357,64149,523079900,25282900,548362800,4,11.43,15
2020,3,08,16,2,33,강원도,58099,3382,61481,508092950,26344240,534437190,4.57,11.43,16
2020,3,08,23,3,34,강원도,23622,4913,28535,202658690,41187290,243845980,6.71,16,23
2020,3,08,30,4,35,강원도,4766,10877,15643,39408940,94682540,134091480,7.57,9.43,17
2020,3,09,06,1,36,강원도,4573,8093,12666,37627900,72197090,109824990,6,8.29,14
2020,3,09,13,2,37,강원도,3306,6613,9919,28970100,58813100,87783200,6.43,10,16
2020,3,09,20,3,38,강원도,2168,7130,9298,17978920,61639260,79618180,5.57,11.29,17
2020,3,09,27,4,39,강원도,6627,5472,12099,56420330,46305260,102725590,7.29,9.86,17
2020,4,10,04,1,40,강원도,36917,9167,46084,348673900,75277100,423951000,11.43,10.29,22
2020,4,10,11,2,41,강원도,16018,5335,21353,143276710,43678410,186955120,11.57,13.86,25
2020,4,10,18,3,42,강원도,13226,2417,15643,115931930,18686440,134618370,10,13.14,23
2020,4,10,25,4,43,강원도,17716,1559,19275,147460700,12446350,159907050,9.43,12.86,22
2020,4,11,01,5,44,강원도,17821,1645,19466,146873520,12804270,159677790,12.43,11.57,24
2020,4,11,08,1,45,강원도,22919,2370,25289,192621470,15811340,208432810,9.86,13.29,23
2020,4,11,15,2,46,강원도,18158,1741,19899,148521150,12862410,161383560,11.86,15,27
2020,4,11,22,3,47,강원도,12697,3512,16209,103525240,28214150,131739390,13.71,17.43,31
2020,4,11,29,4,48,강원도,8200,2817,11017,64512320,23007310,87519630,13.43,17.57,31
2020,4,12,06,1,49,강원도,4462,2100,6562,37366990,17678320,55045310,9.43,19,28
2020,4,12,13,2,50,강원도,3333,1156,4489,29171380,9961180,39132560,9.71,13.29,23
2020,4,12,20,3,51,강원도,2359,1170,3529,20015570,9655450,29671020,8.71,16.86,26
2020,4,12,27,4,52,강원도,1543,6239,7782,13290190,54015030,67305220,7,14,21
2021,1,01,03,5,53,강원도,859,3951,4810,7049020,32314650,39363670,5.86,13.86,20
2020,1,01,05,1,1,경기도,886592,367246,1253838,7569609900,3144057200,10713667100,9.29,17,26
2020,1,01,12,2,2,경기도,259450,451433,710883,2196492050,3889253920,6085745970,12.14,21.43,34
2020,1,01,19,3,3,경기도,283356,307314,590670,2403136000,2620281760,5023417760,13.29,22.86,36
2020,1,01,26,4,4,경기도,1109779,147370,1257149,9907385700,1222798720,11130184420,13,24.71,38
2020,1,02,02,5,5,경기도,681268,100463,781731,5709992980,784273200,6494266180,14.29,27.43,42
2020,1,02,09,1,6,경기도,277894,94965,372859,2423535960,818193080,3241729040,13.43,21.71,35
2020,1,02,16,2,7,경기도,380876,183771,564647,3231820560,1545592210,4777412770,12.43,19.29,32
2020,1,02,23,3,8,경기도,239402,160915,400317,2048658240,1392998540,3441656780,12.57,21,34
2020,1,03,01,4,9,경기도,65711,127102,192813,545719560,1075706760,1621426320,10,22.86,33
2020,1,03,08,1,10,경기도,28883,109929,138812,249028620,938758600,1187787220,9.71,32.29,42
2020,1,03,15,2,11,경기도,14814,93321,108135,119795960,764012340,883808300,9.71,46.43,56
2020,1,03,22,3,12,경기도,9792,66836,76628,70683880,537590740,608274620,9.71,50.57,60
2020,1,03,29,4,13,경기도,7567,66396,73963,55521940,521894700,577416640,10.57,48.43,59
2020,2,04,05,1,14,경기도,5164,49361,54525,36283960,411599660,447883620,12.86,43.29,56
2020,2,04,12,2,15,경기도,2359,34469,36828,16696900,291284020,307980920,13.71,48.71,62
2020,2,04,19,3,16,경기도,7920,42524,50444,70068120,323876020,393944140,12,49.43,61
2020,2,04,26,4,17,경기도,6266,38836,45102,55334120,270712440,326046560,10.29,49.29,60
2020,2,05,03,5,18,경기도,24254,80994,105248,195872440,617878580,813751020,12.57,42.43,55
2020,2,05,10,1,19,경기도,19445,76784,96229,155987340,624132640,780119980,10.43,34.14,45
2020,2,05,17,2,20,경기도,6861,52243,59104,55175840,457257820,512433660,9.71,32.43,42
2020,2,05,24,3,21,경기도,3489,59719,63208,27272140,493931160,521203300,10,37,47
2020,2,05,31,4,22,경기도,4533,65265,69798,34059940,507747260,541807200,12.86,37.43,50
2020,2,06,07,1,23,경기도,69492,54411,123903,644717540,427898560,1072616100,11.86,34.71,47
2020,2,06,14,2,24,경기도,113944,50829,164773,1060826720,399056740,1459883460,11.14,32.86,44
2020,2,06,21,3,25,경기도,105333,65373,170706,950971360,546527260,1497498620,11.14,30.86,42
2020,2,06,28,4,26,경기도,310214,53794,364008,2602578300,415819920,3018398220,10.71,29.71,40
2020,3,07,05,1,27,경기도,151229,39834,191063,1301464620,313205600,1614670220,11.29,35.86,47
2020,3,07,12,2,28,경기도,72399,63890,136289,634730180,509576840,1144307020,15,40.71,56
2020,3,07,19,3,29,경기도,471114,38307,509421,4161878880,291260990,4453139870,12.71,31.57,44
2020,3,07,26,4,30,경기도,263337,44211,307548,2311406780,338739920,2650146700,12.29,34.43,47
2020,3,08,02,5,31,경기도,395778,42975,438753,3291041380,326992720,3618034100,11.29,33.57,45
2020,3,08,09,1,32,경기도,685881,49762,735643,6002436120,388439630,6390875750,7.43,28.14,36
2020,3,08,16,2,33,경기도,596622,42909,639531,5402805540,355841420,5758646960,8.14,25.29,33
2020,3,08,23,3,34,경기도,209693,50482,260175,1885017630,463740840,2348758470,10.14,22.86,33
2020,3,08,30,4,35,경기도,47171,141103,188274,399376040,1261087920,1660463960,11.57,18.71,30
2020,3,09,06,1,36,경기도,43282,91796,135078,354885780,837003480,1191889260,15.86,18.14,34
2020,3,09,13,2,37,경기도,35631,83782,119413,311745790,763865030,1075610820,14,21.71,36
2020,3,09,20,3,38,경기도,22106,91952,114058,185477920,827980470,1013458390,14.29,24.86,39
2020,3,09,27,4,39,경기도,72030,65094,137124,619623330,570538830,1190162160,13.29,22.71,36
2020,4,10,04,1,40,경기도,383074,128561,511635,3579792790,1093267690,4673060480,16.29,20.14,36
2020,4,10,11,2,41,경기도,126860,67254,194114,1175703100,585114590,1760817690,17.29,21.43,39
2020,4,10,18,3,42,경기도,107758,32391,140149,1001821470,279532510,1281353980,17.43,25.14,43
2020,4,10,25,4,43,경기도,159408,34889,194297,1407817010,268465090,1676282100,15.86,27.86,44
2020,4,11,01,5,44,경기도,181001,39629,220630,1633363260,310380990,1943744250,18.43,30.14,49
2020,4,11,08,1,45,경기도,218769,18114,236883,2060134120,164670050,2224804170,15.14,24,39
2020,4,11,15,2,46,경기도,176436,24797,201233,1653041120,208993760,1862034880,16.57,30,47
2020,4,11,22,3,47,경기도,110078,50243,160321,1013141950,455601360,1468743310,19.43,35.43,55
2020,4,11,29,4,48,경기도,67414,36721,104135,573332020,316017420,889349440,15.86,38.14,54
2020,4,12,06,1,49,경기도,45848,30278,76126,396940060,268748870,665688930,16.43,41.43,58
2020,4,12,13,2,50,경기도,34688,16289,50977,306562740,147435860,453998600,18.57,34.57,53
2020,4,12,20,3,51,경기도,23440,13889,37329,210139130,124945960,335085090,16.29,35,51
2020,4,12,27,4,52,경기도,14811,91109,105920,129138570,828753050,957891620,10.43,33.43,44
2021,1,01,03,5,53,경기도,11198,64609,75807,92673070,549514410,642187480,10.71,31.71,42
2020,1,01,05,1,1,경상남도,219278,63712,282990,1822796360,523059560,2345855920,6.43,14.57,21
2020,1,01,12,2,2,경상남도,62912,82024,144936,522372100,673921920,1196294020,6.57,17.43,24
2020,1,01,19,3,3,경상남도,66255,55822,122077,546529890,458801420,1005331310,8.29,16,24
2020,1,01,26,4,4,경상남도,255930,23301,279231,2232114320,185326570,2417440890,8.71,13.43,22
2020,1,02,02,5,5,경상남도,181663,20523,202186,1478788660,156113940,1634902600,9.14,22.57,32
2020,1,02,09,1,6,경상남도,82936,17352,100288,695129300,143702060,838831360,9.57,15.57,25
2020,1,02,16,2,7,경상남도,102800,31846,134646,852049040,259691180,1111740220,9.14,13.57,23
2020,1,02,23,3,8,경상남도,50318,23239,73557,417293520,188699710,605993230,9.29,14.57,24
2020,1,03,01,4,9,경상남도,9647,13846,23493,79238300,113664420,192902720,8.43,10.86,19
2020,1,03,08,1,10,경상남도,5903,16483,22386,50528300,139775360,190303660,9.29,24.71,34
2020,1,03,15,2,11,경상남도,3710,16120,19830,30735900,132967420,163703320,9.29,27.57,37
2020,1,03,22,3,12,경상남도,2615,11814,14429,20239780,95105760,115345540,11.71,29.57,41
2020,1,03,29,4,13,경상남도,1806,10263,12069,13619140,79419140,93038280,9.43,28.86,38
2020,2,04,05,1,14,경상남도,798,7503,8301,5753440,61727420,67480860,9.86,28.14,38
2020,2,04,12,2,15,경상남도,418,6612,7030,2974640,55310680,58285320,7.57,24.14,32
2020,2,04,19,3,16,경상남도,2055,7472,9527,17509080,56651580,74160660,6.71,26.14,33
2020,2,04,26,4,17,경상남도,1107,6227,7334,9249820,42935040,52184860,8.86,28.29,37
2020,2,05,03,5,18,경상남도,4336,13681,18017,34618480,102918080,137536560,11.14,28.14,39
2020,2,05,10,1,19,경상남도,3878,14137,18015,30826460,112958600,143785060,8.86,23.29,32
2020,2,05,17,2,20,경상남도,1487,10663,12150,11678300,90776700,102455000,9.86,23.29,33
2020,2,05,24,3,21,경상남도,878,11585,12463,6317400,93732900,100050300,8,29.57,38
2020,2,05,31,4,22,경상남도,1233,13213,14446,9508040,100362220,109870260,9.29,26,35
2020,2,06,07,1,23,경상남도,18009,10385,28394,163554760,78794920,242349680,7.29,25.86,33
2020,2,06,14,2,24,경상남도,31489,9396,40885,285336080,72190440,357526520,9.14,23,32
2020,2,06,21,3,25,경상남도,29263,11897,41160,259021100,94644140,353665240,10,22.43,32
2020,2,06,28,4,26,경상남도,77500,10555,88055,633227240,77803160,711030400,9.71,20.43,30
2020,3,07,05,1,27,경상남도,40348,7297,47645,338561620,55659860,394221480,10.43,20.43,31
2020,3,07,12,2,28,경상남도,20477,10723,31200,175564580,87244840,262809420,10.29,23,33
2020,3,07,19,3,29,경상남도,115534,4536,120070,988128120,35915060,1024043180,9,16.57,26
2020,3,07,26,4,30,경상남도,66369,8794,75163,565617000,65172300,630789300,7.43,16.86,24
2020,3,08,02,5,31,경상남도,98044,7442,105486,794377800,54556980,848934780,5.43,17.57,23
2020,3,08,09,1,32,경상남도,178255,12966,191221,1517928540,98016420,1615944960,7.29,13.86,21
2020,3,08,16,2,33,경상남도,153481,9276,162757,1352666010,73830240,1426496250,9.71,12.71,22
2020,3,08,23,3,34,경상남도,68122,16087,84209,586474290,132637690,719111980,10.29,15.29,26
2020,3,08,30,4,35,경상남도,14297,29622,43919,119008750,249420020,368428770,10.43,9.71,20
2020,3,09,06,1,36,경상남도,14729,19763,34492,117946170,170723130,288669300,10.29,9.86,20
2020,3,09,13,2,37,경상남도,11408,16566,27974,96213350,142499340,238712690,9.43,10.43,20
2020,3,09,20,3,38,경상남도,7129,19269,26398,58228180,165678290,223906470,10.43,11.14,22
2020,3,09,27,4,39,경상남도,18637,11927,30564,156426730,100211050,256637780,11,9.86,21
2020,4,10,04,1,40,경상남도,104195,25395,129590,920897600,207839870,1128737470,12.86,9.71,23
2020,4,10,11,2,41,경상남도,38934,14447,53381,349126990,118506080,467633070,13.57,15.14,29
2020,4,10,18,3,42,경상남도,30162,5866,36028,265251210,47502340,312753550,13.14,13.43,27
2020,4,10,25,4,43,경상남도,41831,5567,47398,354280380,38480090,392760470,14.14,13.43,28
2020,4,11,01,5,44,경상남도,44818,6440,51258,378757930,46399250,425157180,13.14,15.29,28
2020,4,11,08,1,45,경상남도,51638,2785,54423,453096550,21623950,474720500,10.86,16.43,27
2020,4,11,15,2,46,경상남도,43261,4429,47690,379852490,33169300,413021790,11,18.43,29
2020,4,11,22,3,47,경상남도,27955,8737,36692,239404970,73887560,313292530,12.14,20.29,32
2020,4,11,29,4,48,경상남도,17151,5936,23087,139467050,47974310,187441360,10,23.14,33
2020,4,12,06,1,49,경상남도,10851,4229,15080,91509260,35296430,126805690,10,18.86,29
2020,4,12,13,2,50,경상남도,9356,2339,11695,80725400,20377260,101102660,11.29,15.71,27
2020,4,12,20,3,51,경상남도,6364,2157,8521,55787930,18578020,74365950,11.71,18.43,30
2020,4,12,27,4,52,경상남도,4294,17837,22131,36142330,153393000,189535330,6.71,16.14,23
2021,1,01,03,5,53,경상남도,3181,11150,14331,26182880,91948790,118131670,6.71,15.71,22
2020,1,01,05,1,1,경상북도,138002,38408,176410,1126884200,313986080,1440870280,7,11.29,18
2020,1,01,12,2,2,경상북도,41481,49268,90749,334083140,394339900,728423040,7.43,15,22
2020,1,01,19,3,3,경상북도,41715,34938,76653,333757080,280090560,613847640,8,13.86,22
2020,1,01,26,4,4,경상북도,165060,13697,178757,1421657440,108604240,1530261680,8.57,11.14,20
2020,1,02,02,5,5,경상북도,114190,10496,124686,911495000,78319620,989814620,10.86,13.71,25
2020,1,02,09,1,6,경상북도,51797,9808,61605,427329420,80412120,507741540,9.57,11.29,21
2020,1,02,16,2,7,경상북도,64036,19388,83424,524525900,155417080,679942980,10.29,11.29,22
2020,1,02,23,3,8,경상북도,24290,10495,34785,199626960,83194800,282821760,9,10.71,20
2020,1,03,01,4,9,경상북도,3289,4411,7700,26535800,35063240,61599040,5.29,9.71,15
2020,1,03,08,1,10,경상북도,1495,3977,5472,12919560,33475000,46394560,4.71,13.14,18
2020,1,03,15,2,11,경상북도,1205,4755,5960,9952660,39609980,49562640,5,19.57,25
2020,1,03,22,3,12,경상북도,852,3598,4450,6561940,29350460,35912400,4.86,20.43,25
2020,1,03,29,4,13,경상북도,857,3583,4440,6397120,27438460,33835580,5.14,17.86,23
2020,2,04,05,1,14,경상북도,356,2680,3036,2516260,21913220,24429480,6,16.14,22
2020,2,04,12,2,15,경상북도,110,1974,2084,805460,16044820,16850280,6.43,16.86,23
2020,2,04,19,3,16,경상북도,493,1687,2180,4113600,12892700,17006300,4.29,14.86,19
2020,2,04,26,4,17,경상북도,399,1817,2216,3125480,12725800,15851280,3.71,18.71,22
2020,2,05,03,5,18,경상북도,1916,4410,6326,15300700,32077960,47378660,5.29,18.43,24
2020,2,05,10,1,19,경상북도,1671,5967,7638,13681640,46557180,60238820,6.29,18,24
2020,2,05,17,2,20,경상북도,799,4448,5247,6487800,37133640,43621440,7.43,19.29,27
2020,2,05,24,3,21,경상북도,381,5408,5789,2981040,42588500,45569540,6.29,23.57,30
2020,2,05,31,4,22,경상북도,416,6034,6450,3255180,45680040,48935220,7.86,23.14,31
2020,2,06,07,1,23,경상북도,9464,6031,15495,83763060,43324600,127087660,7.57,18.57,26
2020,2,06,14,2,24,경상북도,16630,5240,21870,147388580,36911920,184300500,6.14,13.57,20
2020,2,06,21,3,25,경상북도,16387,6559,22946,143431700,50444860,193876560,7.57,14.43,22
2020,2,06,28,4,26,경상북도,43967,4711,48678,352590900,34716580,387307480,6.29,10,16
2020,3,07,05,1,27,경상북도,23553,3482,27035,196603760,25953520,222557280,8.57,12.71,21
2020,3,07,12,2,28,경상북도,12363,4748,17111,104739880,38419920,143159800,11.29,17.71,29
2020,3,07,19,3,29,경상북도,66557,2165,68722,563039060,17601200,580640260,9,14.71,24
2020,3,07,26,4,30,경상북도,38231,4447,42678,323098780,33093020,356191800,7.71,16.14,24
2020,3,08,02,5,31,경상북도,52645,3066,55711,423179500,22218800,445398300,9,13.86,23
2020,3,08,09,1,32,경상북도,99883,6655,106538,852300140,49938660,902238800,6.29,10.57,17
2020,3,08,16,2,33,경상북도,91494,5103,96597,796888440,39560760,836449200,8.71,12,21
2020,3,08,23,3,34,경상북도,41552,9656,51208,357534100,79472760,437006860,8.57,10.86,19
2020,3,08,30,4,35,경상북도,10717,20376,31093,88285080,169077920,257363000,7.57,9.57,17
2020,3,09,06,1,36,경상북도,10383,12771,23154,83918470,108034940,191953410,8.29,7.14,15
2020,3,09,13,2,37,경상북도,7592,10007,17599,64607980,85091780,149699760,8.71,7.29,16
2020,3,09,20,3,38,경상북도,3641,9742,13383,29775710,83299930,113075640,9.43,9,18
2020,3,09,27,4,39,경상북도,10283,5749,16032,85681590,46944880,132626470,8.57,8.29,17
2020,4,10,04,1,40,경상북도,54814,10733,65547,475839280,87900050,563739330,12.29,8.71,21
2020,4,10,11,2,41,경상북도,20806,6408,27214,184829440,53113730,237943170,11,11.43,22
2020,4,10,18,3,42,경상북도,17875,2709,20584,156411520,21740470,178151990,12.71,11.71,24
2020,4,10,25,4,43,경상북도,23502,3270,26772,201479400,22236760,223716160,11.29,14.43,26
2020,4,11,01,5,44,경상북도,27034,3243,30277,227856280,22872600,250728880,12.14,12.43,25
2020,4,11,08,1,45,경상북도,30609,1497,32106,269510590,11428630,280939220,10.86,13.57,24
2020,4,11,15,2,46,경상북도,26085,2189,28274,227913630,17117680,245031310,11.86,13,25
2020,4,11,22,3,47,경상북도,18515,4729,23244,159341030,39595510,198936540,10.43,15.86,26
2020,4,11,29,4,48,경상북도,15421,3827,19248,123692350,30833960,154526310,10.71,15.86,27
2020,4,12,06,1,49,경상북도,9204,2954,12158,77537200,24046580,101583780,9.71,14.29,24
2020,4,12,13,2,50,경상북도,6599,1730,8329,56278400,13813040,70091440,8.14,13.71,22
2020,4,12,20,3,51,경상북도,3982,1052,5034,34882740,8747960,43630700,5.71,13.29,19
2020,4,12,27,4,52,경상북도,2334,7886,10220,20259850,66962930,87222780,5.43,12.71,18
2021,1,01,03,5,53,경상북도,1397,4930,6327,11348700,40466400,51815100,5.57,13.29,19
2020,1,01,05,1,1,광주광역시,135688,40835,176523,1109273880,337279620,1446553500,7.43,13.29,21
2020,1,01,12,2,2,광주광역시,41701,55477,97178,339173740,461566460,800740200,7.71,16.14,24
2020,1,01,19,3,3,광주광역시,44637,40849,85486,363129640,338691440,701821080,9.71,16.86,27
2020,1,01,26,4,4,광주광역시,174409,18234,192643,1509042100,146487280,1655529380,9,13.71,23
2020,1,02,02,5,5,광주광역시,130206,13937,144143,1058694420,105273600,1163968020,10.29,15,25
2020,1,02,09,1,6,광주광역시,39991,10297,50288,331400960,85102840,416503800,8.57,12.29,21
2020,1,02,16,2,7,광주광역시,67034,22008,89042,542043020,179518960,721561980,8,12.57,21
2020,1,02,23,3,8,광주광역시,41151,18004,59155,334817000,151204720,486021720,8.57,12.43,21
2020,1,03,01,4,9,광주광역시,13157,18807,31964,105581200,154676280,260257480,6.57,13.57,20
2020,1,03,08,1,10,광주광역시,5827,16406,22233,49997980,134844120,184842100,5.29,20,25
2020,1,03,15,2,11,광주광역시,3248,14755,18003,26400960,118133180,144534140,6.71,31.29,38
2020,1,03,22,3,12,광주광역시,1943,10118,12061,14266340,78934420,93200760,7.43,31.29,39
2020,1,03,29,4,13,광주광역시,1423,9464,10887,11079220,74327340,85406560,7,27.71,35
2020,2,04,05,1,14,광주광역시,720,7195,7915,4837780,59274800,64112580,8.71,26.86,36
2020,2,04,12,2,15,광주광역시,388,6363,6751,2919940,51723540,54643480,6.43,32,38
2020,2,04,19,3,16,광주광역시,1754,6574,8328,15151780,48781120,63932900,6,30.57,37
2020,2,04,26,4,17,광주광역시,1340,5444,6784,11122620,38779360,49901980,6.71,29.86,37
2020,2,05,03,5,18,광주광역시,4425,11549,15974,35380440,85815820,121196260,10.43,26,36
2020,2,05,10,1,19,광주광역시,3657,11748,15405,28682120,90885360,119567480,8.43,21,29
2020,2,05,17,2,20,광주광역시,1479,8425,9904,11613940,69262540,80876480,9.43,22,31
2020,2,05,24,3,21,광주광역시,1358,9989,11347,8787880,78760640,87548520,9.43,26.29,36
2020,2,05,31,4,22,광주광역시,1112,11368,12480,7729600,86254940,93984540,10.29,28,38
2020,2,06,07,1,23,광주광역시,15165,8251,23416,139245780,64796440,204042220,7.71,22.71,30
2020,2,06,14,2,24,광주광역시,24991,7454,32445,230780440,58421620,289202060,9.43,17.43,27
2020,2,06,21,3,25,광주광역시,21881,8423,30304,197193320,68894880,266088200,8.86,15.86,25
2020,2,06,28,4,26,광주광역시,50671,7489,58160,432545860,57284900,489830760,8,15.86,24
2020,3,07,05,1,27,광주광역시,16193,2955,19148,136996480,23301100,160297580,8.71,17.14,26
2020,3,07,12,2,28,광주광역시,5706,3516,9222,51093860,28836640,79930500,8.57,18.71,27
2020,3,07,19,3,29,광주광역시,45178,1896,47074,385897540,15247380,401144920,8.29,13.86,22
2020,3,07,26,4,30,광주광역시,30304,4243,34547,257573540,32788740,290362280,9.29,15.71,25
2020,3,08,02,5,31,광주광역시,50954,3864,54818,406380280,29091420,435471700,6.29,15,21
2020,3,08,09,1,32,광주광역시,91236,4217,95453,756508060,32471900,788979960,7.29,13.57,21
2020,3,08,16,2,33,광주광역시,88068,5268,93336,788232420,43877660,832110080,8.14,13.71,22
2020,3,08,23,3,34,광주광역시,38638,7457,46095,331000800,64675460,395676260,10.71,13.86,25
2020,3,08,30,4,35,광주광역시,9422,15741,25163,76359060,141175200,217534260,9.29,10.14,19
2020,3,09,06,1,36,광주광역시,8919,12742,21661,70741910,115877670,186619580,8.14,8.57,17
2020,3,09,13,2,37,광주광역시,7091,10360,17451,59472080,92369510,151841590,9,11.14,20
2020,3,09,20,3,38,광주광역시,4462,11397,15859,35986170,100746430,136732600,7.86,12.86,21
2020,3,09,27,4,39,광주광역시,11300,7695,18995,93738190,66412410,160150600,10.57,12.29,23
2020,4,10,04,1,40,광주광역시,63023,13699,76722,556388820,113134830,669523650,14.14,12.43,27
2020,4,10,11,2,41,광주광역시,26079,8141,34220,226437590,66672080,293109670,15.86,14,30
2020,4,10,18,3,42,광주광역시,21401,4185,25586,186457200,33906520,220363720,14.14,14.14,28
2020,4,10,25,4,43,광주광역시,28929,3051,31980,241777200,25508110,267285310,12.57,13.86,26
2020,4,11,01,5,44,광주광역시,32019,3521,35540,285604390,29683340,315287730,13.29,11.57,25
2020,4,11,08,1,45,광주광역시,37211,3145,40356,352668830,27446180,380115010,10.71,11.86,23
2020,4,11,15,2,46,광주광역시,28127,2915,31042,262679760,24866810,287546570,11,16.14,27
2020,4,11,22,3,47,광주광역시,15929,5527,21456,143349990,47890480,191240470,13.86,19.57,33
2020,4,11,29,4,48,광주광역시,13820,4825,18645,114734220,39346600,154080820,13,20.29,33
2020,4,12,06,1,49,광주광역시,9279,4164,13443,78337410,35933190,114270600,10.86,19.71,31
2020,4,12,13,2,50,광주광역시,7442,2945,10387,65486530,25075470,90562000,10.14,20.57,31
2020,4,12,20,3,51,광주광역시,5810,2120,7930,51568190,17973640,69541830,9.71,20,30
2020,4,12,27,4,52,광주광역시,3986,11756,15742,35322460,103443790,138766250,8,16.71,25
2021,1,01,03,5,53,광주광역시,2450,7644,10094,20668520,64573930,85242450,6.43,18.43,25
2020,1,01,05,1,1,대구광역시,191324,77611,268935,1647295860,656565580,2303861440,9.57,15.57,25
2020,1,01,12,2,2,대구광역시,55718,88902,144620,479167280,767950040,1247117320,9.71,18.14,28
2020,1,01,19,3,3,대구광역시,60438,68625,129063,518730480,586065460,1104795940,12,22,34
2020,1,01,26,4,4,대구광역시,241191,28952,270143,2181560740,233660280,2415221020,11,17,28
2020,1,02,02,5,5,대구광역시,163115,24915,188030,1368688860,184107160,1552796020,10.86,19.43,30
2020,1,02,09,1,6,대구광역시,74671,23391,98062,649652000,195663740,845315740,10.71,15.57,26
2020,1,02,16,2,7,대구광역시,96842,39180,136022,822209680,324964940,1147174620,9.71,16.57,26
2020,1,02,23,3,8,대구광역시,26512,14417,40929,219319960,118602220,337922180,8.43,14.29,23
2020,1,03,01,4,9,대구광역시,3725,6128,9853,29889920,49328320,79218240,6.86,10.86,18
2020,1,03,08,1,10,대구광역시,1,71,72,7000,355000,362000,0.14,1,1
2020,1,03,15,2,11,대구광역시,341,1468,1809,2689700,12956120,15645820,2.43,7.14,10
2020,1,03,22,3,12,대구광역시,45,56,101,305000,366000,671000,1.43,2.14,4
2020,1,03,29,4,13,대구광역시,9,0,9,62000,0,62000,0.71,0,1
2020,2,04,05,1,14,대구광역시,3,1059,1062,6000,8472000,8478000,0.43,0.29,1
2020,2,04,12,2,15,대구광역시,19,10,29,103000,70000,173000,1.29,0.14,1
2020,2,04,19,3,16,대구광역시,5,0,5,10000,0,10000,0.71,0,1
2020,2,04,26,4,17,대구광역시,109,537,646,772000,3905600,4677600,4.29,4.86,9
2020,2,05,03,5,18,대구광역시,2572,7701,10273,21287500,58637600,79925100,7.29,13.43,21
2020,2,05,10,1,19,대구광역시,2842,11760,14602,22609220,93113820,115723040,9.29,22.71,32
2020,2,05,17,2,20,대구광역시,1633,9777,11410,13246880,82492860,95739740,9.57,25.29,35
2020,2,05,24,3,21,대구광역시,858,10493,11351,6411360,85056220,91467580,9.86,31.43,41
2020,2,05,31,4,22,대구광역시,912,10088,11000,6785200,77561740,84346940,10.57,29.57,40
2020,2,06,07,1,23,대구광역시,17116,11742,28858,152275900,88237640,240513540,9.14,26.71,36
2020,2,06,14,2,24,대구광역시,28373,13251,41624,257023120,100818760,357841880,8.29,27.43,36
2020,2,06,21,3,25,대구광역시,26329,14487,40816,230066400,113316860,343383260,9.14,24.14,33
2020,2,06,28,4,26,대구광역시,66199,13263,79462,549142000,95232600,644374600,8.43,20.71,29
2020,3,07,05,1,27,대구광역시,31770,8351,40121,272615060,65185100,337800160,10.71,26.14,37
2020,3,07,12,2,28,대구광역시,16627,12410,29037,145724360,101595120,247319480,11.86,29.29,41
2020,3,07,19,3,29,대구광역시,95641,6299,101940,838802340,50653320,889455660,9.14,21.29,30
2020,3,07,26,4,30,대구광역시,58504,10664,69168,509366500,80260040,589626540,8,22.71,31
2020,3,08,02,5,31,대구광역시,81926,8515,90441,672442400,63004520,735446920,9,23,32
2020,3,08,09,1,32,대구광역시,152385,9839,162224,1330197200,74912320,1405109520,9.43,19.29,29
2020,3,08,16,2,33,대구광역시,143973,14952,158925,1300733200,117870700,1418603900,10.43,18.43,29
2020,3,08,23,3,34,대구광역시,66084,16352,82436,587215240,140913820,728129060,8.86,18,27
2020,3,08,30,4,35,대구광역시,15111,39788,54899,126932650,337267710,464200360,9.57,12.71,22
2020,3,09,06,1,36,대구광역시,15780,25307,41087,127972660,220175350,348148010,11.86,11,23
2020,3,09,13,2,37,대구광역시,12273,20493,32766,106675480,179267410,285942890,13.71,12.86,27
2020,3,09,20,3,38,대구광역시,6732,20247,26979,56293490,177346430,233639920,11.71,14.29,26
2020,3,09,27,4,39,대구광역시,19923,13010,32933,168967340,111304860,280272200,11.57,12.57,24
2020,4,10,04,1,40,대구광역시,94989,25008,119997,886330740,210403770,1096734510,15.43,11.43,27
2020,4,10,11,2,41,대구광역시,35328,14969,50297,345228810,127965390,473194200,17,15.14,32
2020,4,10,18,3,42,대구광역시,30443,6287,36730,290426500,52193840,342620340,16.14,17.57,34
2020,4,10,25,4,43,대구광역시,41101,5878,46979,364940950,48045160,412986110,14,17.43,31
2020,4,11,01,5,44,대구광역시,45967,10117,56084,404830200,76719150,481549350,14.14,17.43,32
2020,4,11,08,1,45,대구광역시,51781,8531,60312,479469710,67280260,546749970,12.57,15.14,28
2020,4,11,15,2,46,대구광역시,44673,10106,54779,408149060,75520470,483669530,11.86,17.43,29
2020,4,11,22,3,47,대구광역시,30949,15191,46140,279048080,130613900,409661980,14.29,21.29,36
2020,4,11,29,4,48,대구광역시,25455,9799,35254,213582700,82186690,295769390,12.71,25.14,38
2020,4,12,06,1,49,대구광역시,16464,7241,23705,141590880,61759430,203350310,14.29,24.86,39
2020,4,12,13,2,50,대구광역시,12491,4545,17036,109379160,41828630,151207790,16.29,23.71,40
2020,4,12,20,3,51,대구광역시,9018,3741,12759,79288530,32908490,112197020,14.57,25,40
2020,4,12,27,4,52,대구광역시,4720,20732,25452,40665100,180006760,220671860,11.71,20.14,32
2021,1,01,03,5,53,대구광역시,3345,14345,17690,27060500,118032780,145093280,9.86,21.86,32
2020,1,01,05,1,1,대전광역시,124221,47630,171851,1078234180,409745600,1487979780,4.86,14.29,19
2020,1,01,12,2,2,대전광역시,37470,60440,97910,322413880,522290240,844704120,5.86,15.29,21
2020,1,01,19,3,3,대전광역시,43224,41930,85154,367799100,357104160,724903260,8,18.43,26
2020,1,01,26,4,4,대전광역시,163860,19403,183263,1461968200,159989560,1621957760,7.57,15.14,23
2020,1,02,02,5,5,대전광역시,107801,15111,122912,906097900,118884700,1024982600,8.57,17.71,26
2020,1,02,09,1,6,대전광역시,50699,15189,65888,437139300,129639220,566778520,6.86,13.43,20
2020,1,02,16,2,7,대전광역시,65325,26734,92059,548707100,223915180,772622280,7.14,14.86,22
2020,1,02,23,3,8,대전광역시,34187,21200,55387,288725260,179119800,467845060,9,13.86,23
2020,1,03,01,4,9,대전광역시,7424,13805,21229,61730360,115251260,176981620,7,14.14,21
2020,1,03,08,1,10,대전광역시,3774,13443,17217,32965060,112273140,145238200,7,22.57,30
2020,1,03,15,2,11,대전광역시,2134,13310,15444,17263120,107004160,124267280,6,31,37
2020,1,03,22,3,12,대전광역시,1691,9655,11346,11408920,76858220,88267140,7.14,34.29,41
2020,1,03,29,4,13,대전광역시,1322,9843,11165,9526600,77238580,86765180,8.14,29.86,38
2020,2,04,05,1,14,대전광역시,663,6893,7556,4339160,57093260,61432420,9.57,28,38
2020,2,04,12,2,15,대전광역시,397,5488,5885,2711960,45585160,48297120,7.43,32.71,40
2020,2,04,19,3,16,대전광역시,1277,6417,7694,10876400,48381600,59258000,6.86,31.43,38
2020,2,04,26,4,17,대전광역시,711,5773,6484,5972400,39680640,45653040,5,30.14,35
2020,2,05,03,5,18,대전광역시,4374,11310,15684,33776100,85854420,119630520,9.57,24,34
2020,2,05,10,1,19,대전광역시,2940,11209,14149,23733080,90904600,114637680,8.86,20.86,30
2020,2,05,17,2,20,대전광역시,1175,7891,9066,9236840,68940480,78177320,7.14,22.29,29
2020,2,05,24,3,21,대전광역시,737,9451,10188,5313320,76348480,81661800,7.29,26.57,34
2020,2,05,31,4,22,대전광역시,838,11052,11890,6290540,83977500,90268040,7.71,25,33
2020,2,06,07,1,23,대전광역시,13288,9509,22797,123065860,70835640,193901500,6.57,21.71,28
2020,2,06,14,2,24,대전광역시,21722,8752,30474,202780000,67105500,269885500,8.14,17.71,26
2020,2,06,21,3,25,대전광역시,13846,6761,20607,124000060,55934000,179934060,9.14,15.29,24
2020,2,06,28,4,26,대전광역시,35150,5185,40335,293080880,40104380,333185260,7.14,15.71,23
2020,3,07,05,1,27,대전광역시,16725,3934,20659,144012160,30824500,174836660,7.71,19.29,27
2020,3,07,12,2,28,대전광역시,7703,5610,13313,67964960,46007160,113972120,8.29,21.43,30
2020,3,07,19,3,29,대전광역시,60096,3059,63155,526710760,25197540,551908300,7.14,14.86,22
2020,3,07,26,4,30,대전광역시,37097,6326,43423,325376680,47562920,372939600,5.86,16.29,22
2020,3,08,02,5,31,대전광역시,56139,5444,61583,461903620,41128000,503031620,6,16.71,23
2020,3,08,09,1,32,대전광역시,100754,6433,107187,876141880,50153440,926295320,6.57,13.86,20
2020,3,08,16,2,33,대전광역시,95369,6342,101711,858695760,53960840,912656600,6.71,14.29,21
2020,3,08,23,3,34,대전광역시,41635,10378,52013,368898120,91803040,460701160,10.71,14.29,25
2020,3,08,30,4,35,대전광역시,9394,26665,36059,79261180,233494220,312755400,10.14,10.71,21
2020,3,09,06,1,36,대전광역시,9981,17061,27042,80413740,153094130,233507870,10.71,8.14,19
2020,3,09,13,2,37,대전광역시,6818,12762,19580,59617520,113100350,172717870,10.29,10.14,20
2020,3,09,20,3,38,대전광역시,3860,14128,17988,32566380,124473720,157040100,8.86,13.71,23
2020,3,09,27,4,39,대전광역시,12451,9083,21534,105270160,78396950,183667110,8.71,13.71,22
2020,4,10,04,1,40,대전광역시,65124,17399,82523,603271970,147317600,750589570,13.29,13.14,26
2020,4,10,11,2,41,대전광역시,22376,9366,31742,206427750,78896460,285324210,14.43,15.71,30
2020,4,10,18,3,42,대전광역시,17978,3856,21834,167205630,32785570,199991200,13.71,14.71,28
2020,4,10,25,4,43,대전광역시,25232,5694,30926,222110740,42432410,264543150,12,16.29,28
2020,4,11,01,5,44,대전광역시,27718,5367,33085,251803080,42477860,294280940,13.57,16.86,30
2020,4,11,08,1,45,대전광역시,35248,2960,38208,331700290,26745010,358445300,12.29,15,27
2020,4,11,15,2,46,대전광역시,28776,4088,32864,268924550,34369520,303294070,12.57,19.14,32
2020,4,11,22,3,47,대전광역시,20943,8649,29592,193691030,78084370,271775400,11.43,24.14,36
2020,4,11,29,4,48,대전광역시,15476,6851,22327,134171210,59298930,193470140,11.71,23,35
2020,4,12,06,1,49,대전광역시,8964,5081,14045,78520700,45644920,124165620,11.86,21.71,34
2020,4,12,13,2,50,대전광역시,6857,2862,9719,61212220,25558080,86770300,13.29,22.43,36
2020,4,12,20,3,51,대전광역시,4648,2555,7203,40769940,22667940,63437880,12.14,22.71,35
2020,4,12,27,4,52,대전광역시,3223,13940,17163,28147310,125373570,153520880,9.43,19.86,29
2021,1,01,03,5,53,대전광역시,1756,9916,11672,14538620,83504020,98042640,7.86,18.86,27
2020,1,01,05,1,1,부산광역시,259917,100974,360891,2187501340,839127060,3026628400,10.71,19,30
2020,1,01,12,2,2,부산광역시,77334,117927,195261,646149540,991811420,1637960960,9.29,22.71,32
2020,1,01,19,3,3,부산광역시,81610,87376,168986,682146820,721200900,1403347720,11.43,26.57,38
2020,1,01,26,4,4,부산광역시,324281,40776,365057,2841587080,327199220,3168786300,11.71,21.14,33
2020,1,02,02,5,5,부산광역시,216882,34194,251076,1783017280,256137340,2039154620,14.14,26.57,41
2020,1,02,09,1,6,부산광역시,104650,34585,139235,886505060,281275140,1167780200,12.14,23.29,35
2020,1,02,16,2,7,부산광역시,134772,53658,188430,1115398040,434444000,1549842040,11.29,19.14,30
2020,1,02,23,3,8,부산광역시,70523,38923,109446,584242460,319318080,903560540,10.57,20,31
2020,1,03,01,4,9,부산광역시,11755,21663,33418,95928280,178285920,274214200,8.57,19.86,28
2020,1,03,08,1,10,부산광역시,7905,25411,33316,68182540,213880600,282063140,8.29,26.29,35
2020,1,03,15,2,11,부산광역시,5256,26952,32208,43326600,217216620,260543220,7.57,35.29,43
2020,1,03,22,3,12,부산광역시,3407,19967,23374,25662880,156814520,182477400,6.71,38.29,45
2020,1,03,29,4,13,부산광역시,2756,19150,21906,20645820,147108500,167754320,8.71,40,49
2020,2,04,05,1,14,부산광역시,1479,14392,15871,10077040,117544100,127621140,11.71,34.43,46
2020,2,04,12,2,15,부산광역시,705,12506,13211,4805780,103602800,108408580,9.71,38.86,49
2020,2,04,19,3,16,부산광역시,3123,12821,15944,26758860,96715780,123474640,9.14,36.29,45
2020,2,04,26,4,17,부산광역시,1750,10967,12717,14353940,74986340,89340280,6.86,34.14,41
2020,2,05,03,5,18,부산광역시,6182,22341,28523,49323040,167951120,217274160,9.57,30.57,40
2020,2,05,10,1,19,부산광역시,4788,22924,27712,37322760,180897320,218220080,10.43,26.14,37
2020,2,05,17,2,20,부산광역시,2160,18182,20342,16545460,152654160,169199620,11.43,28.86,40
2020,2,05,24,3,21,부산광역시,1882,20888,22770,12954260,167209180,180163440,12.86,33.86,47
2020,2,05,31,4,22,부산광역시,3191,22754,25945,22312120,171390800,193702920,13.86,33.71,48
2020,2,06,07,1,23,부산광역시,25873,18034,43907,234401640,135795640,370197280,13,30.71,44
2020,2,06,14,2,24,부산광역시,45280,18483,63763,413316840,143451880,556768720,11.57,28.43,40
2020,2,06,21,3,25,부산광역시,42569,19458,62027,375429600,158233360,533662960,12.29,25.71,38
2020,2,06,28,4,26,부산광역시,101195,16900,118095,841887620,126731020,968618640,11,23.14,34
2020,3,07,05,1,27,부산광역시,53991,14387,68378,456273640,109465280,565738920,12.57,30.86,43
2020,3,07,12,2,28,부산광역시,26920,20180,47100,231664780,164247620,395912400,12.57,29.29,42
2020,3,07,19,3,29,부산광역시,143792,11692,155484,1247079380,84351580,1331430960,12.14,25,37
2020,3,07,26,4,30,부산광역시,84117,18704,102821,725005040,132307840,857312880,10.43,29.71,40
2020,3,08,02,5,31,부산광역시,125278,14773,140051,1027434840,105682780,1133117620,8.86,30.57,39
2020,3,08,09,1,32,부산광역시,206530,16865,223395,1789300480,127443840,1916744320,9.14,24.43,34
2020,3,08,16,2,33,부산광역시,183111,14097,197208,1644979220,112950490,1757929710,9,24.57,34
2020,3,08,23,3,34,부산광역시,75504,19162,94666,670902580,166950390,837852970,11.14,23.71,35
2020,3,08,30,4,35,부산광역시,19862,50101,69963,166059070,434921360,600980430,12.14,15.14,27
2020,3,09,06,1,36,부산광역시,19099,33619,52718,154062050,301583120,455645170,11.43,13.57,25
2020,3,09,13,2,37,부산광역시,15614,28847,44461,134011410,255156610,389168020,11.71,13.71,25
2020,3,09,20,3,38,부산광역시,9155,30432,39587,76271050,265756770,342027820,10.57,16.86,27
2020,3,09,27,4,39,부산광역시,26428,19129,45557,223164740,163884070,387048810,11.43,17.43,29
2020,4,10,04,1,40,부산광역시,113543,33753,147296,1094413740,280362100,1374775840,19.57,18.71,38
2020,4,10,11,2,41,부산광역시,42298,22674,64972,394519790,187734230,582254020,20.57,21.14,42
2020,4,10,18,3,42,부산광역시,35932,9690,45622,342933190,79474640,422407830,15.14,19.29,34
2020,4,10,25,4,43,부산광역시,53743,7710,61453,480198080,61925530,542123610,12.86,19,32
2020,4,11,01,5,44,부산광역시,61264,12245,73509,533822290,92463330,626285620,14,21.43,35
2020,4,11,08,1,45,부산광역시,75960,8999,84959,692688750,67581570,760270320,15.43,24.29,40
2020,4,11,15,2,46,부산광역시,64309,11662,75971,587252060,90429070,677681130,14.29,27.57,42
2020,4,11,22,3,47,부산광역시,47086,21070,68156,418127300,180158810,598286110,15.71,31.57,47
2020,4,11,29,4,48,부산광역시,28471,13542,42013,235450430,111171350,346621780,13.57,33.29,47
2020,4,12,06,1,49,부산광역시,14802,9040,23842,125215780,76281340,201497120,14.43,32.29,47
2020,4,12,13,2,50,부산광역시,13516,6629,20145,117041200,56006670,173047870,15.43,29.57,45
2020,4,12,20,3,51,부산광역시,9390,6099,15489,79691870,51059440,130751310,15.43,31.43,47
2020,4,12,27,4,52,부산광역시,5477,27925,33402,44939720,244444950,289384670,11.57,27,39
2021,1,01,03,5,53,부산광역시,3912,21097,25009,31156780,173628180,204784960,10.71,32.86,44
2020,1,01,05,1,1,서울특별시,781593,505712,1287305,6751957701,4337655540,11089613241,23.43,45.86,69
2020,1,01,12,2,2,서울특별시,242995,560239,803234,2064804860,4991447880,7056252740,21.71,50,72
2020,1,01,19,3,3,서울특별시,264706,406502,671208,2303896120,3484323500,5788219620,22.29,51.71,74
2020,1,01,26,4,4,서울특별시,1013105,222626,1235731,9045974980,1889199840,10935174820,21.57,48.57,70
2020,1,02,02,5,5,서울특별시,633986,168409,802395,5400476858,1368113242,6768590100,23.14,49.43,73
2020,1,02,09,1,6,서울특별시,301896,162510,464406,2582337520,1450184260,4032521780,22.29,46.29,69
2020,1,02,16,2,7,서울특별시,386355,264122,650477,3266329230,2306224740,5572553970,20.71,43.71,64
2020,1,02,23,3,8,서울특별시,271145,244633,515778,2298171060,2235349140,4533520200,21.14,39.43,61
2020,1,03,01,4,9,서울특별시,76957,190153,267110,634286520,1684687940,2318974460,17.71,42.57,60
2020,1,03,08,1,10,서울특별시,33984,166004,199988,298362240,1466205000,1764567240,15.86,45,61
2020,1,03,15,2,11,서울특별시,20111,143684,163795,170953160,1182078000,1353031160,16.29,63,79
2020,1,03,22,3,12,서울특별시,18030,104138,122168,134659140,849646740,984305880,16.43,74,90
2020,1,03,29,4,13,서울특별시,13379,112292,125671,108442680,908355840,1016798520,16.29,72.57,89
2020,2,04,05,1,14,서울특별시,10661,81112,91773,76490660,684244480,760735140,18.71,71.14,90
2020,2,04,12,2,15,서울특별시,5075,62733,67808,34556200,529398800,563955000,18.86,87.14,106
2020,2,04,19,3,16,서울특별시,10957,72144,83101,93131860,554794000,647925860,22.71,87.57,110
2020,2,04,26,4,17,서울특별시,10984,75260,86244,97161300,546745340,643906640,23.29,80.57,104
2020,2,05,03,5,18,서울특별시,34076,127298,161374,248384020,990764100,1239148120,21.71,74.71,96
2020,2,05,10,1,19,서울특별시,16841,113172,130013,140253220,946112920,1086366140,16.57,64,81
2020,2,05,17,2,20,서울특별시,13509,87013,100522,106822980,753474820,860297800,16.57,64.43,81
2020,2,05,24,3,21,서울특별시,8468,95663,104131,62543880,817512640,880056520,20.86,69.86,91
2020,2,05,31,4,22,서울특별시,19654,100835,120489,144495820,809969300,954465120,25.57,67.86,93
2020,2,06,07,1,23,서울특별시,80435,90114,170549,720742080,732529220,1453271300,22,66.43,88
2020,2,06,14,2,24,서울특별시,124254,96983,221237,1174583380,782578280,1957161660,17.43,68,85
2020,2,06,21,3,25,서울특별시,114492,106065,220557,1034839860,917321940,1952161800,19.43,67.29,87
2020,2,06,28,4,26,서울특별시,306064,99189,405253,2588019520,770257680,3358277200,21.43,68.71,90
2020,3,07,05,1,27,서울특별시,161255,77680,238935,1393203280,627645360,2020848640,23.29,70.14,93
2020,3,07,12,2,28,서울특별시,81191,107192,188383,696972040,879616400,1576588440,30,80.14,110
2020,3,07,19,3,29,서울특별시,453757,66843,520600,4048663160,513770440,4562433600,27.43,73.86,101
2020,3,07,26,4,30,서울특별시,273587,92180,365767,2380604100,753126090,3133730190,26.43,67.86,94
2020,3,08,02,5,31,서울특별시,391258,80176,471434,3260830360,610556570,3871386930,25.14,65,90
2020,3,08,09,1,32,서울특별시,633579,63558,697137,5543614870,514196290,6057811160,25.43,59.86,85
2020,3,08,16,2,33,서울특별시,593022,67760,660782,5301326930,568748989,5870075919,25,55.86,81
2020,3,08,23,3,34,서울특별시,208914,67096,276010,1868848390,618531730,2487380120,27.43,54,81
2020,3,08,30,4,35,서울특별시,57323,198839,256162,470201550,1798418820,2268620370,23.57,45,69
2020,3,09,06,1,36,서울특별시,50025,140849,190874,411269660,1350887800,1762157460,23.57,33.71,57
2020,3,09,13,2,37,서울특별시,64229,124270,188499,538241530,1186739300,1724980830,26.57,32.86,59
2020,3,09,20,3,38,서울특별시,38986,135486,174472,315830210,1262050730,1577880940,24.29,38.86,63
2020,3,09,27,4,39,서울특별시,98631,100785,199416,806342882,912546450,1718889332,26.71,40.14,67
2020,4,10,04,1,40,서울특별시,325328,158744,484072,3153817240,1438096640,4591913880,24.29,46.71,71
2020,4,10,11,2,41,서울특별시,118385,100259,218644,1146679840,910383690,2057063530,25.57,43.43,69
2020,4,10,18,3,42,서울특별시,118593,56490,175083,1123070970,514356410,1637427380,26.29,44.57,71
2020,4,10,25,4,43,서울특별시,192545,59948,252493,1694548170,488011670,2182559840,28.71,52.71,81
2020,4,11,01,5,44,서울특별시,207949,63752,271701,1899718200,534017960,2433736160,28.43,52,80
2020,4,11,08,1,45,서울특별시,253442,48850,302292,2346588980,446198890,2792787870,30.43,44.29,75
2020,4,11,15,2,46,서울특별시,208021,63605,271626,1920680730,532603740,2453284470,35.14,56.86,92
2020,4,11,22,3,47,서울특별시,123664,89260,212924,1142662900,793322820,1935985720,37.14,62.29,99
2020,4,11,29,4,48,서울특별시,77997,63480,141477,653301030,531392180,1184693210,41.14,60.71,102
2020,4,12,06,1,49,서울특별시,56323,49733,106056,459122060,429694550,888816610,34,62.57,97
2020,4,12,13,2,50,서울특별시,48165,37796,85961,399111950,338972890,738084840,28.57,54.57,83
2020,4,12,20,3,51,서울특별시,37088,30594,67682,291782170,282505250,574287420,28.86,53.43,82
2020,4,12,27,4,52,서울특별시,28183,125906,154089,205949390,1157975510,1363924900,24.57,54.57,79
2021,1,01,03,5,53,서울특별시,18113,97098,115211,137737550,835134950,972872500,21.14,52.71,74
2020,1,01,05,1,1,세종특별자치시,19956,7805,27761,162931020,64384280,227315300,4.14,4.71,9
2020,1,01,12,2,2,세종특별자치시,5665,9255,14920,47045620,76298400,123344020,4.57,5,10
2020,1,01,19,3,3,세종특별자치시,6642,5756,12398,53733680,46990560,100724240,4.57,6.43,11
2020,1,01,26,4,4,세종특별자치시,25430,3347,28777,214147780,26003300,240151080,6.14,4.86,11
2020,1,02,02,5,5,세종특별자치시,16463,2832,19295,130927360,21178080,152105440,5.14,5.43,11
2020,1,02,09,1,6,세종특별자치시,6398,1828,8226,53313280,14498240,67811520,4.71,5.29,10
2020,1,02,16,2,7,세종특별자치시,7547,5209,12756,61329480,41965980,103295460,4.71,5.57,10
2020,1,02,23,3,8,세종특별자치시,4166,3345,7511,33728300,27018600,60746900,3.86,5.71,10
2020,1,03,01,4,9,세종특별자치시,1170,2413,3583,9049860,18849540,27899400,4.14,6.43,11
2020,1,03,08,1,10,세종특별자치시,525,2076,2601,4170460,16556880,20727340,4.43,11.71,16
2020,1,03,15,2,11,세종특별자치시,184,1369,1553,1396420,10146320,11542740,3.71,15.43,19
2020,1,03,22,3,12,세종특별자치시,157,1104,1261,939940,8033140,8973080,2.86,13.86,17
2020,1,03,29,4,13,세종특별자치시,191,1153,1344,1209320,8390580,9599900,2.71,14.14,17
2020,2,04,05,1,14,세종특별자치시,69,908,977,391660,7235100,7626760,2.14,12,14
2020,2,04,12,2,15,세종특별자치시,18,596,614,124500,4834480,4958980,1,11.57,13
2020,2,04,19,3,16,세종특별자치시,132,765,897,1166460,5778240,6944700,1.57,14,16
2020,2,04,26,4,17,세종특별자치시,119,695,814,1025460,4787620,5813080,2.14,12,14
2020,2,05,03,5,18,세종특별자치시,556,1912,2468,4065580,13954000,18019580,5.29,9.57,15
2020,2,05,10,1,19,세종특별자치시,420,2011,2431,3243040,15740420,18983460,4.71,9.57,14
2020,2,05,17,2,20,세종특별자치시,104,1202,1306,793000,9893040,10686040,1.71,12.71,14
2020,2,05,24,3,21,세종특별자치시,50,1448,1498,364000,11258780,11622780,1.71,15.86,18
2020,2,05,31,4,22,세종특별자치시,58,1486,1544,400640,10926060,11326700,1,13.29,14
2020,2,06,07,1,23,세종특별자치시,1474,1394,2868,13083260,10369080,23452340,1.86,9.86,12
2020,2,06,14,2,24,세종특별자치시,3065,1566,4631,26827840,11261700,38089540,2.71,8.57,11
2020,2,06,21,3,25,세종특별자치시,2140,1624,3764,18110200,12580700,30690900,4.14,5.71,10
2020,2,06,28,4,26,세종특별자치시,6366,1460,7826,50766060,11164580,61930640,4.57,4.14,9
2020,3,07,05,1,27,세종특별자치시,3204,979,4183,25981820,7187540,33169360,4.43,7.29,12
2020,3,07,12,2,28,세종특별자치시,1497,1325,2822,12427480,10390400,22817880,5.71,10,16
2020,3,07,19,3,29,세종특별자치시,11443,571,12014,93356520,4635500,97992020,3.57,6.86,10
2020,3,07,26,4,30,세종특별자치시,7088,1285,8373,57430460,9566880,66997340,2.29,7,9
2020,3,08,02,5,31,세종특별자치시,10417,784,11201,81377000,5730400,87107400,1.86,5.57,7
2020,3,08,09,1,32,세종특별자치시,16760,1906,18666,138532560,13977080,152509640,2.71,3.29,6
2020,3,08,16,2,33,세종특별자치시,15991,1902,17893,138713980,14823980,153537960,3.71,4.29,8
2020,3,08,23,3,34,세종특별자치시,6255,1960,8215,52549650,16535160,69084810,4.57,6,11
2020,3,08,30,4,35,세종특별자치시,1179,4574,5753,9450920,37315080,46766000,3,4.29,7
2020,3,09,06,1,36,세종특별자치시,1309,3313,4622,10049780,27529650,37579430,2.71,3.29,6
2020,3,09,13,2,37,세종특별자치시,706,2465,3171,5786480,20442420,26228900,2.29,4.43,7
2020,3,09,20,3,38,세종특별자치시,481,2735,3216,3823900,22709520,26533420,3.14,5.86,9
2020,3,09,27,4,39,세종특별자치시,2201,1814,4015,17737500,14570180,32307680,4,4.57,9
2020,4,10,04,1,40,세종특별자치시,10020,3753,13773,91503300,30092710,121596010,7.14,5.86,13
2020,4,10,11,2,41,세종특별자치시,2847,1724,4571,26723290,14083440,40806730,6.29,10.14,16
2020,4,10,18,3,42,세종특별자치시,2603,710,3313,23369520,5909970,29279490,5.57,9.29,15
2020,4,10,25,4,43,세종특별자치시,3759,1647,5406,31454420,10659280,42113700,5.29,6.86,12
2020,4,11,01,5,44,세종특별자치시,4667,2414,7081,40176970,15537080,55714050,5.86,6.14,12
2020,4,11,08,1,45,세종특별자치시,5579,412,5991,49406670,3861670,53268340,4.57,4.43,9
2020,4,11,15,2,46,세종특별자치시,4520,431,4951,38826150,3553450,42379600,5.71,4.29,10
2020,4,11,22,3,47,세종특별자치시,3492,1081,4573,29215910,9324690,38540600,6.43,7.57,14
2020,4,11,29,4,48,세종특별자치시,2022,733,2755,16124820,6366210,22491030,5.71,6.14,12
2020,4,12,06,1,49,세종특별자치시,1279,665,1944,10306840,5583420,15890260,5.14,6.43,12
2020,4,12,13,2,50,세종특별자치시,1099,351,1450,9017710,3221140,12238850,6.57,7.43,14
2020,4,12,20,3,51,세종특별자치시,1025,375,1400,7926790,3086200,11012990,6.57,8.57,15
2020,4,12,27,4,52,세종특별자치시,471,2726,3197,3655360,22630680,26286040,5.29,8,13
2021,1,01,03,5,53,세종특별자치시,240,1831,2071,1744810,14121880,15866690,3.86,10.86,15
2020,1,01,05,1,1,울산광역시,90764,29912,120676,768204480,253903940,1022108420,4.14,7.57,12
2020,1,01,12,2,2,울산광역시,28765,35591,64356,238587320,305201920,543789240,5.29,10.71,16
2020,1,01,19,3,3,울산광역시,30113,26045,56158,249354300,222374540,471728840,6.57,11.43,18
2020,1,01,26,4,4,울산광역시,99930,10480,110410,890008140,85636220,975644360,6.29,7,13
2020,1,02,02,5,5,울산광역시,71379,9001,80380,591733220,66003560,657736780,6.43,10.29,17
2020,1,02,09,1,6,울산광역시,33761,9020,42781,285847120,77343340,363190460,6.14,10.71,17
2020,1,02,16,2,7,울산광역시,43714,14526,58240,359337860,120752120,480089980,6.43,11.29,18
2020,1,02,23,3,8,울산광역시,21477,11821,33298,178192120,106399380,284591500,7.29,11,18
2020,1,03,01,4,9,울산광역시,2837,4827,7664,23353820,42753920,66107740,6.57,10,17
2020,1,03,08,1,10,울산광역시,1447,5544,6991,12730080,48224880,60954960,4.71,19.71,24
2020,1,03,15,2,11,울산광역시,868,5887,6755,7211140,46882420,54093560,5.57,27.86,33
2020,1,03,22,3,12,울산광역시,467,4175,4642,3558260,33373640,36931900,5,30.14,35
2020,1,03,29,4,13,울산광역시,433,4439,4872,3124000,35861740,38985740,5.86,24,30
2020,2,04,05,1,14,울산광역시,453,3335,3788,3092400,28508320,31600720,7.71,17,25
2020,2,04,12,2,15,울산광역시,200,2466,2666,1409900,22022700,23432600,5.29,16.86,22
2020,2,04,19,3,16,울산광역시,595,2987,3582,5242800,24186700,29429500,3.14,17.29,20
2020,2,04,26,4,17,울산광역시,339,2988,3327,2924200,21779600,24703800,3.29,20.43,24
2020,2,05,03,5,18,울산광역시,1936,6030,7966,15680140,47852760,63532900,8.43,18,26
2020,2,05,10,1,19,울산광역시,1424,6147,7571,11637540,49485280,61122820,5.71,19.57,25
2020,2,05,17,2,20,울산광역시,727,4356,5083,5052320,37882280,42934600,4.43,20.71,25
2020,2,05,24,3,21,울산광역시,396,4810,5206,2889680,39716540,42606220,4.71,24.14,29
2020,2,05,31,4,22,울산광역시,510,5746,6256,4000760,44335960,48336720,4.71,22.71,27
2020,2,06,07,1,23,울산광역시,7071,4855,11926,64552200,38046600,102598800,5.71,19.29,25
2020,2,06,14,2,24,울산광역시,13115,4816,17931,120001480,37228580,157230060,5,15.57,21
2020,2,06,21,3,25,울산광역시,11940,5806,17746,105511560,48663800,154175360,5.71,14.29,20
2020,2,06,28,4,26,울산광역시,32531,4820,37351,267049840,36576460,303626300,5.57,12.43,18
2020,3,07,05,1,27,울산광역시,16851,3772,20623,140957560,30474740,171432300,5.14,12.71,18
2020,3,07,12,2,28,울산광역시,8464,4860,13324,72179980,40447640,112627620,5.57,15.29,21
2020,3,07,19,3,29,울산광역시,45233,2686,47919,394818540,22203980,417022520,5.86,12,18
2020,3,07,26,4,30,울산광역시,25255,4241,29496,217986380,33155560,251141940,5,14.14,19
2020,3,08,02,5,31,울산광역시,35366,3805,39171,288988560,29113760,318102320,4.86,16.29,21
2020,3,08,09,1,32,울산광역시,75915,7336,83251,644420040,55781440,700201480,3.86,11.14,15
2020,3,08,16,2,33,울산광역시,61846,5002,66848,532812070,40775820,573587890,4.29,10.14,14
2020,3,08,23,3,34,울산광역시,27906,6624,34530,236707520,58801010,295508530,6.71,11.43,18
2020,3,08,30,4,35,울산광역시,5943,14183,20126,50151570,132613020,182764590,6,8.86,15
2020,3,09,06,1,36,울산광역시,4515,7341,11856,36384560,71326280,107710840,4.71,6,11
2020,3,09,13,2,37,울산광역시,3047,5288,8335,26800100,50866200,77666300,5.14,6.43,12
2020,3,09,20,3,38,울산광역시,2308,6654,8962,19392860,62117250,81510110,6,9.71,16
2020,3,09,27,4,39,울산광역시,7467,4953,12420,62384610,44736240,107120850,6.71,7.86,15
2020,4,10,04,1,40,울산광역시,38359,10129,48488,356788800,86250980,443039780,10.14,7.14,17
2020,4,10,11,2,41,울산광역시,12986,5952,18938,122406480,50932850,173339330,10.43,10.71,21
2020,4,10,18,3,42,울산광역시,11340,2880,14220,106443430,24359640,130803070,9.29,11.86,21
2020,4,10,25,4,43,울산광역시,17245,2598,19843,149901110,20775720,170676830,9,10.43,19
2020,4,11,01,5,44,울산광역시,18757,3163,21920,167760820,26140610,193901430,10.57,11.86,22
2020,4,11,08,1,45,울산광역시,23226,1208,24434,214033660,10863480,224897140,7.29,10.14,17
2020,4,11,15,2,46,울산광역시,20536,2631,23167,189551710,21368750,210920460,6.57,12,19
2020,4,11,22,3,47,울산광역시,15016,5042,20058,136102860,44957720,181060580,9.29,17,26
2020,4,11,29,4,48,울산광역시,8880,3304,12184,77702700,28464910,106167610,7,16.57,24
2020,4,12,06,1,49,울산광역시,5292,2813,8105,47404150,25564580,72968730,6.43,17.86,24
2020,4,12,13,2,50,울산광역시,2934,1388,4322,27728560,12566460,40295020,8.57,16.71,25
2020,4,12,20,3,51,울산광역시,2203,1203,3406,21487520,11011700,32499220,7,18.14,25
2020,4,12,27,4,52,울산광역시,1776,6827,8603,15757370,64118430,79875800,6.14,14.57,21
2021,1,01,03,5,53,울산광역시,997,5038,6035,8130490,43529310,51659800,4.86,15,20
2020,1,01,05,1,1,인천광역시,188042,71113,259155,1607194600,605057840,2212252440,8.57,18.43,27
2020,1,01,12,2,2,인천광역시,56202,87068,143270,478086660,743460980,1221547640,8.29,21,29
2020,1,01,19,3,3,인천광역시,60622,59946,120568,517562520,503862620,1021425140,10,22.71,33
2020,1,01,26,4,4,인천광역시,232219,30081,262300,2076992760,248901660,2325894420,10.57,19.43,30
2020,1,02,02,5,5,인천광역시,151449,21829,173278,1269645100,165775820,1435420920,12.14,22.57,35
2020,1,02,09,1,6,인천광역시,62431,19897,82328,543764760,168036120,711800880,12.43,19.14,32
2020,1,02,16,2,7,인천광역시,85123,33592,118715,724038920,277360620,1001399540,8.57,17.29,26
2020,1,02,23,3,8,인천광역시,54880,30250,85130,469104520,254924460,724028980,8.43,17.14,26
2020,1,03,01,4,9,인천광역시,16383,27853,44236,135030740,233909800,368940540,8.43,17,25
2020,1,03,08,1,10,인천광역시,6971,24141,31112,60487060,206903960,267391020,8.29,26.86,35
2020,1,03,15,2,11,인천광역시,3289,19228,22517,26654240,157746640,184400880,8,38.71,47
2020,1,03,22,3,12,인천광역시,2039,13605,15644,14834860,110582200,125417060,6.29,38.29,45
2020,1,03,29,4,13,인천광역시,1706,13431,15137,12308420,107093000,119401420,6.14,32.71,39
2020,2,04,05,1,14,인천광역시,989,11160,12149,6923680,94165320,101089000,8.43,27.86,36
2020,2,04,12,2,15,인천광역시,652,7554,8206,4430480,63169580,67600060,7.29,28.29,36
2020,2,04,19,3,16,인천광역시,1706,8821,10527,14822180,67691600,82513780,6.71,29.29,36
2020,2,04,26,4,17,인천광역시,1288,7673,8961,10677040,54619580,65296620,7.29,31.14,38
2020,2,05,03,5,18,인천광역시,5932,17133,23065,46304340,130795320,177099660,12.29,27.29,40
2020,2,05,10,1,19,인천광역시,4372,15921,20293,34691980,128087600,162779580,8.43,22.57,31
2020,2,05,17,2,20,인천광역시,1317,10192,11509,10546820,86767480,97314300,7.43,24,31
2020,2,05,24,3,21,인천광역시,674,10435,11109,4971940,84574200,89546140,7.14,28.14,35
2020,2,05,31,4,22,인천광역시,977,11561,12538,6813180,88746680,95559860,8.57,27.57,36
2020,2,06,07,1,23,인천광역시,13797,9603,23400,128109260,74898260,203007520,6.43,22.43,29
2020,2,06,14,2,24,인천광역시,23414,9381,32795,218857780,72715960,291573740,6.57,21,28
2020,2,06,21,3,25,인천광역시,22357,11709,34066,201877580,98027440,299905020,8.86,19.43,28
2020,2,06,28,4,26,인천광역시,65419,9547,74966,553659060,73067960,626727020,8.29,19,27
2020,3,07,05,1,27,인천광역시,33182,7727,40909,285202400,59263640,344466040,7.86,24.57,32
2020,3,07,12,2,28,인천광역시,15745,10819,26564,138332220,88204760,226536980,9.29,24.71,34
2020,3,07,19,3,29,인천광역시,105503,4998,110501,930742720,40460520,971203240,8.57,19,28
2020,3,07,26,4,30,인천광역시,58738,9632,68370,511652220,72183080,583835300,8.71,21.29,30
2020,3,08,02,5,31,인천광역시,82563,8096,90659,686072680,59108800,745181480,10.71,27.14,38
2020,3,08,09,1,32,인천광역시,149596,9638,159234,1310031400,75508480,1385539880,10.29,20.14,30
2020,3,08,16,2,33,인천광역시,138567,9496,148063,1257533620,80227720,1337761340,7,21.43,28
2020,3,08,23,3,34,인천광역시,52239,12504,64743,470311490,110443800,580755290,9.43,18.71,28
2020,3,08,30,4,35,인천광역시,12055,29300,41355,102447130,256795230,359242360,11.14,11.14,22
2020,3,09,06,1,36,인천광역시,11839,19877,31716,96202170,177651060,273853230,11.14,11.57,23
2020,3,09,13,2,37,인천광역시,9062,18792,27854,79314990,166353630,245668620,10,12.86,23
2020,3,09,20,3,38,인천광역시,6044,19381,25425,53661060,170463910,224124970,7.14,15,22
2020,3,09,27,4,39,인천광역시,16931,13460,30391,145858500,114874070,260732570,9,13.14,22
2020,4,10,04,1,40,인천광역시,91505,26019,117524,847968140,219452050,1067420190,12.86,12.86,26
2020,4,10,11,2,41,인천광역시,31964,14203,46167,299211710,120930640,420142350,13.29,14.86,28
2020,4,10,18,3,42,인천광역시,24678,6533,31211,230014290,55372600,285386890,15.71,18.29,34
2020,4,10,25,4,43,인천광역시,35954,5964,41918,317257940,48620270,365878210,15.86,20.86,37
2020,4,11,01,5,44,인천광역시,40481,6669,47150,367090550,54194710,421285260,17.29,21.43,39
2020,4,11,08,1,45,인천광역시,50816,5053,55869,475526800,39677970,515204770,14.71,18.71,33
2020,4,11,15,2,46,인천광역시,43126,6502,49628,393461000,49814290,443275290,14.43,23.86,38
2020,4,11,22,3,47,인천광역시,26674,13856,40530,243382860,103228550,346611410,16,28,44
2020,4,11,29,4,48,인천광역시,15009,8381,23390,129855210,69240020,199095230,14.71,28.57,43
2020,4,12,06,1,49,인천광역시,10709,6739,17448,93972480,58463940,152436420,13.71,30.29,44
2020,4,12,13,2,50,인천광역시,8003,3552,11555,69944560,32026160,101970720,16.14,23.71,40
2020,4,12,20,3,51,인천광역시,5175,3319,8494,47351170,27820580,75171750,15,26.14,41
2020,4,12,27,4,52,인천광역시,5627,19242,24869,42707760,172487050,215194810,11.14,24.43,36
2021,1,01,03,5,53,인천광역시,3631,14252,17883,27388120,120796500,148184620,10.29,23.86,34
2020,1,01,05,1,1,전라남도,96281,22942,119223,757897900,182135040,940032940,4.29,5.71,10
2020,1,01,12,2,2,전라남도,30750,32828,63578,238229640,255294920,493524560,4.57,6.57,11
2020,1,01,19,3,3,전라남도,30648,23094,53742,238226780,178362120,416588900,5.14,7.29,12
2020,1,01,26,4,4,전라남도,121952,10601,132553,1017098740,80372920,1097471660,5.43,6.43,12
2020,1,02,02,5,5,전라남도,91960,7072,99032,714728640,50181180,764909820,6.57,6.43,13
2020,1,02,09,1,6,전라남도,33867,4751,38618,267055980,39055660,306111640,6.43,4,10
2020,1,02,16,2,7,전라남도,47363,12336,59699,370898100,97273360,468171460,5.29,4.71,10
2020,1,02,23,3,8,전라남도,28518,12660,41178,225226940,98375660,323602600,6.29,7.43,14
2020,1,03,01,4,9,전라남도,7980,8954,16934,62089540,70159820,132249360,6,9.43,15
2020,1,03,08,1,10,전라남도,3223,8286,11509,26510700,66171160,92681860,5,12.86,18
2020,1,03,15,2,11,전라남도,2057,7796,9853,14848600,59638420,74487020,4.43,18.14,23
2020,1,03,22,3,12,전라남도,1256,5419,6675,8016100,41598660,49614760,5.14,18.57,24
2020,1,03,29,4,13,전라남도,809,3990,4799,5528860,29887340,35416200,5.43,17.29,23
2020,2,04,05,1,14,전라남도,413,3535,3948,2587380,28901640,31489020,6,13.14,19
2020,2,04,12,2,15,전라남도,307,2655,2962,2164500,21962240,24126740,5.29,16,21
2020,2,04,19,3,16,전라남도,928,3202,4130,7752400,23439920,31192320,3.86,18.57,22
2020,2,04,26,4,17,전라남도,461,2696,3157,3659840,18048040,21707880,3.43,18.86,22
2020,2,05,03,5,18,전라남도,2402,5681,8083,18855780,39931780,58787560,6.86,16,23
2020,2,05,10,1,19,전라남도,2529,6152,8681,18621260,45366080,63987340,8.29,14.14,22
2020,2,05,17,2,20,전라남도,906,3936,4842,7140160,32168460,39308620,5.57,14.71,20
2020,2,05,24,3,21,전라남도,662,4866,5528,4725400,37683260,42408660,6.14,19.86,26
2020,2,05,31,4,22,전라남도,367,5997,6364,2595340,44396260,46991600,5.86,19.43,25
2020,2,06,07,1,23,전라남도,7893,4285,12178,71309420,32798100,104107520,5.43,17.14,23
2020,2,06,14,2,24,전라남도,15312,3322,18634,138313940,25815160,164129100,5.57,12.29,18
2020,2,06,21,3,25,전라남도,14011,4587,18598,123300840,37090740,160391580,5.57,9.86,15
2020,2,06,28,4,26,전라남도,31831,3126,34957,267456520,24483600,291940120,5.43,7.29,13
2020,3,07,05,1,27,전라남도,14885,1888,16773,122438840,14361640,136800480,5.57,9.71,15
2020,3,07,12,2,28,전라남도,7035,2945,9980,59080080,24165700,83245780,5.71,13.71,19
2020,3,07,19,3,29,전라남도,41760,1467,43227,349850920,12017900,361868820,5.71,8.71,14
2020,3,07,26,4,30,전라남도,27012,3140,30152,222189600,24711760,246901360,5.43,10.29,16
2020,3,08,02,5,31,전라남도,39052,2447,41499,308734620,18222980,326957600,4.43,8.57,13
2020,3,08,09,1,32,전라남도,68927,4982,73909,570790320,37004880,607795200,3.29,6.86,10
2020,3,08,16,2,33,전라남도,69554,4058,73612,610519060,31609800,642128860,3.71,6.86,11
2020,3,08,23,3,34,전라남도,29283,4965,34248,239338860,39404860,278743720,5.43,8.14,14
2020,3,08,30,4,35,전라남도,4510,6738,11248,35809640,54874140,90683780,4.29,4.57,9
2020,3,09,06,1,36,전라남도,4797,6574,11371,36989780,54194070,91183850,3.71,5.43,9
2020,3,09,13,2,37,전라남도,3356,6188,9544,27130950,50834940,77965890,3.57,6.29,10
2020,3,09,20,3,38,전라남도,2262,7228,9490,17822300,59233680,77055980,4.43,7.43,12
2020,3,09,27,4,39,전라남도,7530,4326,11856,60247790,35233810,95481600,4.86,5.43,10
2020,4,10,04,1,40,전라남도,44866,8108,52974,375508370,66347840,441856210,8.29,5.57,14
2020,4,10,11,2,41,전라남도,15859,4449,20308,131063790,36362800,167426590,9.14,9.71,19
2020,4,10,18,3,42,전라남도,13357,2103,15460,108612030,16403700,125015730,9,10.29,19
2020,4,10,25,4,43,전라남도,16929,1312,18241,132108250,10270620,142378870,6.71,8.43,15
2020,4,11,01,5,44,전라남도,19206,2081,21287,166455940,15471000,181926940,8.57,8,17
2020,4,11,08,1,45,전라남도,23434,869,24303,210121700,7354280,217475980,6.86,8.14,15
2020,4,11,15,2,46,전라남도,14986,693,15679,131265450,5710640,136976090,7,7.71,15
2020,4,11,22,3,47,전라남도,8244,1636,9880,65715440,13462210,79177650,8.14,8.57,17
2020,4,11,29,4,48,전라남도,6533,1345,7878,50978270,11183040,62161310,6.86,11.29,18
2020,4,12,06,1,49,전라남도,5652,1438,7090,44968110,11970880,56938990,7.43,9,16
2020,4,12,13,2,50,전라남도,4143,1118,5261,34118040,9242870,43360910,7,10.29,17
2020,4,12,20,3,51,전라남도,3573,850,4423,28947700,7042510,35990210,5.29,10.14,15
2020,4,12,27,4,52,전라남도,2314,7430,9744,19058430,61031990,80090420,3.43,8.43,12
2021,1,01,03,5,53,전라남도,1361,4457,5818,11368620,36375280,47743900,4,8.29,12
2020,1,01,05,1,1,전라북도,118183,35292,153475,946933580,282356280,1229289860,7.29,14.43,22
2020,1,01,12,2,2,전라북도,35844,46833,82677,282842340,380705880,663548220,8.29,16.29,25
2020,1,01,19,3,3,전라북도,40950,33295,74245,322318840,262772680,585091520,10.14,17.43,28
2020,1,01,26,4,4,전라북도,160336,23962,184298,1360792480,136613110,1497405590,8.43,14.43,23
2020,1,02,02,5,5,전라북도,102795,18454,121249,811849920,93254560,905104480,8.71,15.43,24
2020,1,02,09,1,6,전라북도,44485,13280,57765,362660540,89747680,452408220,8.29,11.71,20
2020,1,02,16,2,7,전라북도,61230,20947,82177,486732420,165404540,652136960,10,11.71,22
2020,1,02,23,3,8,전라북도,30667,14527,45194,244584300,114869260,359453560,8,12,20
2020,1,03,01,4,9,전라북도,9360,13626,22986,73821620,110767640,184589260,6.43,12.43,19
2020,1,03,08,1,10,전라북도,3904,11661,15565,33286980,97751320,131038300,5.86,17.29,23
2020,1,03,15,2,11,전라북도,2309,10462,12771,17957140,83885680,101842820,7.29,21.29,29
2020,1,03,22,3,12,전라북도,1538,7011,8549,10274880,55364280,65639160,7.29,24.14,31
2020,1,03,29,4,13,전라북도,728,3628,4356,5116660,27065180,32181840,5.14,20.86,26
2020,2,04,05,1,14,전라북도,231,1679,1910,1624800,13956680,15581480,4.29,15.71,20
2020,2,04,12,2,15,전라북도,78,1605,1683,513480,14317880,14831360,2.29,15.43,18
2020,2,04,19,3,16,전라북도,694,2056,2750,5963120,15726200,21689320,3.29,18.29,22
2020,2,04,26,4,17,전라북도,1344,1958,3302,8390460,13313320,21703780,4.14,22.43,27
2020,2,05,03,5,18,전라북도,2492,6877,9369,20045100,50576320,70621420,7.57,22.57,30
2020,2,05,10,1,19,전라북도,2594,7508,10102,19681580,53851160,73532740,7.14,22.71,30
2020,2,05,17,2,20,전라북도,1192,5110,6302,9321820,43303820,52625640,6.57,21.29,28
2020,2,05,24,3,21,전라북도,592,6274,6866,4340480,48368180,52708660,7.43,24.43,32
2020,2,05,31,4,22,전라북도,629,6805,7434,4472920,51133700,55606620,6.71,23.43,30
2020,2,06,07,1,23,전라북도,9682,5263,14945,87329480,39874000,127203480,5.43,19.57,25
2020,2,06,14,2,24,전라북도,16294,4308,20602,147073000,33753980,180826980,6.43,15.43,22
2020,2,06,21,3,25,전라북도,14346,5133,19479,124968420,42080700,167049120,7.29,17.43,25
2020,2,06,28,4,26,전라북도,36219,3925,40144,295450240,29866080,325316320,6.29,14.71,21
2020,3,07,05,1,27,전라북도,19709,3354,23063,166062300,26843140,192905440,8.29,15.86,24
2020,3,07,12,2,28,전라북도,10138,5100,15238,84978240,42207200,127185440,8.14,18.86,27
2020,3,07,19,3,29,전라북도,58432,1880,60312,499464440,15434500,514898940,6.71,11.71,18
2020,3,07,26,4,30,전라북도,33580,4034,37614,285705800,28824040,314529840,7.71,14.29,22
2020,3,08,02,5,31,전라북도,48714,3708,52422,394370100,26600100,420970200,7.29,14.71,22
2020,3,08,09,1,32,전라북도,85499,5946,91445,726202220,43046400,769248620,4.71,11.43,16
2020,3,08,16,2,33,전라북도,84579,5762,90341,736030460,45258000,781288460,4.86,10.86,16
2020,3,08,23,3,34,전라북도,34927,6842,41769,297169460,59061720,356231180,5.71,14.29,20
2020,3,08,30,4,35,전라북도,7199,15627,22826,59579530,137725650,197305180,5.71,9.57,15
2020,3,09,06,1,36,전라북도,8360,13262,21622,66787520,118205350,184992870,8.86,9.29,18
2020,3,09,13,2,37,전라북도,6960,10001,16961,57960640,88849400,146810040,7.86,8.29,16
2020,3,09,20,3,38,전라북도,3581,9682,13263,28215540,84364580,112580120,7.86,12.43,20
2020,3,09,27,4,39,전라북도,9447,5924,15371,78350750,50504760,128855510,8.29,9.86,18
2020,4,10,04,1,40,전라북도,54794,12057,66851,478734250,97987360,576721610,11.43,8.86,20
2020,4,10,11,2,41,전라북도,18758,6712,25470,161758420,55364880,217123300,12.71,12.71,25
2020,4,10,18,3,42,전라북도,16291,2873,19164,139448210,23409030,162857240,11.57,14.29,26
2020,4,10,25,4,43,전라북도,22728,1869,24597,189570000,15075540,204645540,12.29,14,26
2020,4,11,01,5,44,전라북도,25694,2547,28241,217847330,19845280,237692610,14,14.14,28
2020,4,11,08,1,45,전라북도,32642,1696,34338,288040920,13230010,301270930,12,14.43,26
2020,4,11,15,2,46,전라북도,27337,3294,30631,236335550,24526090,260861640,10.43,18.29,29
2020,4,11,22,3,47,전라북도,16143,5206,21349,138017400,44432660,182450060,10.71,20.14,31
2020,4,11,29,4,48,전라북도,10211,4425,14636,82391340,35662080,118053420,8.71,21.29,30
2020,4,12,06,1,49,전라북도,5763,2695,8458,48557330,23251000,71808330,8.86,21.86,31
2020,4,12,13,2,50,전라북도,5958,1727,7685,50492660,15090170,65582830,10.86,16.29,27
2020,4,12,20,3,51,전라북도,4140,1372,5512,36093140,12153350,48246490,8.86,20,29
2020,4,12,27,4,52,전라북도,2500,10729,13229,21241150,93138580,114379730,5.43,17,22
2021,1,01,03,5,53,전라북도,1606,7056,8662,13100820,58018550,71119370,4.71,17.71,22
2020,1,01,05,1,1,제주특별자치도,43601,12414,56015,363647800,103438780,467086580,4.14,7,11
2020,1,01,12,2,2,제주특별자치도,13846,18365,32211,117000260,155717460,272717720,4.57,8.86,13
2020,1,01,19,3,3,제주특별자치도,14610,13319,27929,125407540,111099580,236507120,4.57,8.86,13
2020,1,01,26,4,4,제주특별자치도,50549,6784,57333,447524060,55354220,502878280,4.86,6.57,11
2020,1,02,02,5,5,제주특별자치도,35435,4186,39621,301319480,33332500,334651980,5.57,8.43,14
2020,1,02,09,1,6,제주특별자치도,16722,3735,20457,145083580,32190720,177274300,5.57,6.43,12
2020,1,02,16,2,7,제주특별자치도,21751,8045,29796,186946120,67257420,254203540,5.14,5.86,11
2020,1,02,23,3,8,제주특별자치도,12304,6380,18684,105003820,52535540,157539360,5.71,6.86,13
2020,1,03,01,4,9,제주특별자치도,4520,6672,11192,37540700,55454480,92995180,4.29,7.29,12
2020,1,03,08,1,10,제주특별자치도,1859,5473,7332,15927780,45945820,61873600,3.43,13.14,17
2020,1,03,15,2,11,제주특별자치도,1057,4855,5912,8379500,39123240,47502740,5.14,20.86,26
2020,1,03,22,3,12,제주특별자치도,703,3251,3954,5354900,25336240,30691140,4.86,23.86,29
2020,1,03,29,4,13,제주특별자치도,444,2872,3316,3313980,21489420,24803400,4.43,20.14,25
2020,2,04,05,1,14,제주특별자치도,218,1743,1961,1425400,13898200,15323600,5,17.57,23
2020,2,04,12,2,15,제주특별자치도,97,1310,1407,669500,10789580,11459080,3.14,15.43,19
2020,2,04,19,3,16,제주특별자치도,505,1502,2007,4375500,10977000,15352500,2.14,16.43,19
2020,2,04,26,4,17,제주특별자치도,241,1325,1566,1975400,8406540,10381940,2.71,17.57,20
2020,2,05,03,5,18,제주특별자치도,1505,2793,4298,10325100,20843260,31168360,4.57,13,18
2020,2,05,10,1,19,제주특별자치도,1014,3026,4040,7954600,24444120,32398720,4.71,12.86,18
2020,2,05,17,2,20,제주특별자치도,407,2178,2585,3095400,19041140,22136540,5.14,14,19
2020,2,05,24,3,21,제주특별자치도,124,2506,2630,920460,20514880,21435340,3.29,18.86,22
2020,2,05,31,4,22,제주특별자치도,270,3100,3370,2054240,23586900,25641140,3.43,18.29,22
2020,2,06,07,1,23,제주특별자치도,3540,2348,5888,31599060,17696900,49295960,3.57,14.57,18
2020,2,06,14,2,24,제주특별자치도,7580,2929,10509,69147760,22460040,91607800,4.71,12.57,17
2020,2,06,21,3,25,제주특별자치도,6285,2903,9188,57990600,23736660,81727260,5.43,8.57,14
2020,2,06,28,4,26,제주특별자치도,16465,2532,18997,138940140,19370640,158310780,4.71,9.14,14
2020,3,07,05,1,27,제주특별자치도,9626,2023,11649,82953760,15906060,98859820,5.43,8.43,14
2020,3,07,12,2,28,제주특별자치도,4655,2574,7229,40794000,21224680,62018680,6.14,11.57,18
2020,3,07,19,3,29,제주특별자치도,22540,955,23495,195476700,7888100,203364800,5.29,6.86,12
2020,3,07,26,4,30,제주특별자치도,12177,1787,13964,105260300,13290700,118551000,4.29,7,11
2020,3,08,02,5,31,제주특별자치도,15886,1583,17469,132648180,11973200,144621380,3.29,8.86,12
2020,3,08,09,1,32,제주특별자치도,31515,1694,33209,273929880,13673000,287602880,2.86,6.71,10
2020,3,08,16,2,33,제주특별자치도,33957,1897,35854,298291660,15495000,313786660,3.71,6.57,10
2020,3,08,23,3,34,제주특별자치도,18396,4322,22718,162092920,37112000,199204920,4.29,7.86,12
2020,3,08,30,4,35,제주특별자치도,4714,8229,12943,39526500,69581260,109107760,4.57,5.57,10
2020,3,09,06,1,36,제주특별자치도,3113,4353,7466,25730100,37757140,63487240,5,4.14,9
2020,3,09,13,2,37,제주특별자치도,2882,4048,6930,24934600,34895060,59829660,5.86,4.57,10
2020,3,09,20,3,38,제주특별자치도,1913,4416,6329,16124600,38410580,54535180,6.71,7,14
2020,3,09,27,4,39,제주특별자치도,4170,3072,7242,35858800,26536340,62395140,6.29,5.86,12
2020,4,10,04,1,40,제주특별자치도,20758,4535,25293,189438480,38869120,228307600,8.71,5.57,14
2020,4,10,11,2,41,제주특별자치도,8282,2816,11098,73632170,23856750,97488920,9.57,10,20
2020,4,10,18,3,42,제주특별자치도,6782,1232,8014,61258200,10289700,71547900,8.57,8.14,17
2020,4,10,25,4,43,제주특별자치도,9326,614,9940,80234210,5041940,85276150,7.57,7,15
2020,4,11,01,5,44,제주특별자치도,9650,707,10357,85285630,5775180,91060810,8.57,5.71,14
2020,4,11,08,1,45,제주특별자치도,10968,450,11418,99488960,3902940,103391900,6.14,6.14,12
2020,4,11,15,2,46,제주특별자치도,9212,883,10095,83635260,7020160,90655420,5.86,9.29,15
2020,4,11,22,3,47,제주특별자치도,7214,2078,9292,65186860,18091030,83277890,7.14,11.57,19
2020,4,11,29,4,48,제주특별자치도,5213,1766,6979,44257630,14691560,58949190,5.29,11,16
2020,4,12,06,1,49,제주특별자치도,3714,1346,5060,32185980,11628770,43814750,5.71,8.57,14
2020,4,12,13,2,50,제주특별자치도,3020,779,3799,26516990,6748440,33265430,6.57,9.14,16
2020,4,12,20,3,51,제주특별자치도,1496,436,1932,13137540,3718420,16855960,5.43,10.29,16
2020,4,12,27,4,52,제주특별자치도,749,2740,3489,6371080,23763890,30134970,5,9.57,15
2021,1,01,03,5,53,제주특별자치도,576,2305,2881,4603120,19143690,23746810,3.86,12,16
2020,1,01,05,1,1,충청남도,124516,39752,164268,1047167150,337404880,1384572030,8.14,14.43,23
2020,1,01,12,2,2,충청남도,38369,55788,94157,322218810,462818280,785037090,8.43,16.14,25
2020,1,01,19,3,3,충청남도,45507,39823,85330,362895050,322069250,684964300,9.57,18,28
2020,1,01,26,4,4,충청남도,149651,17039,166690,1286774090,137518150,1424292240,7.57,15,23
2020,1,02,02,5,5,충청남도,101073,11744,112817,809422710,88042380,897465090,9.71,17.57,27
2020,1,02,09,1,6,충청남도,45911,12493,58404,388814130,100495760,489309890,10,14.86,25
2020,1,02,16,2,7,충청남도,59259,22361,81620,490051830,180181400,670233230,9.86,15.43,25
2020,1,02,23,3,8,충청남도,36746,18982,55728,308112370,154451810,462564180,9.57,15.43,25
2020,1,03,01,4,9,충청남도,7642,10083,17725,61758590,82267330,144025920,6.29,13.14,19
2020,1,03,08,1,10,충청남도,2798,10187,12985,23790590,84892140,108682730,5.14,20.29,25
2020,1,03,15,2,11,충청남도,1884,9042,10926,14654420,73193260,87847680,4.86,26.57,31
2020,1,03,22,3,12,충청남도,1303,6616,7919,8832260,53489640,62321900,5.86,26.71,33
2020,1,03,29,4,13,충청남도,1203,6140,7343,8236760,47962700,56199460,7.14,25.86,33
2020,2,04,05,1,14,충청남도,529,5318,5847,3123780,44356280,47480060,8.14,24.29,32
2020,2,04,12,2,15,충청남도,295,4161,4456,2053000,35267600,37320600,6.86,25.14,32
2020,2,04,19,3,16,충청남도,1143,5179,6322,9911800,40995720,50907520,4.71,23.71,28
2020,2,04,26,4,17,충청남도,721,4317,5038,5995960,31982540,37978500,4.57,26.29,31
2020,2,05,03,5,18,충청남도,3243,8251,11494,25629140,63040040,88669180,7.71,23.43,31
2020,2,05,10,1,19,충청남도,2841,9865,12706,22662080,75208180,97870260,7.29,21.29,29
2020,2,05,17,2,20,충청남도,1748,6143,7891,13227320,52793440,66020760,7.43,23.71,31
2020,2,05,24,3,21,충청남도,815,7407,8222,5595980,58741600,64337580,7.57,27.29,35
2020,2,05,31,4,22,충청남도,727,8354,9081,5051860,63780500,68832360,8.71,25.14,34
2020,2,06,07,1,23,충청남도,11028,6540,17568,100512600,50177540,150690140,6.14,20.43,27
2020,2,06,14,2,24,충청남도,18044,5787,23831,162489480,43856620,206346100,5.14,20.71,26
2020,2,06,21,3,25,충청남도,17213,7728,24941,151672460,61949100,213621560,6.43,18.29,25
2020,2,06,28,4,26,충청남도,43957,6418,50375,361897020,47976420,409873440,6.29,13.43,20
2020,3,07,05,1,27,충청남도,23034,4184,27218,195436900,33204360,228641260,8.29,15.43,24
2020,3,07,12,2,28,충청남도,10997,5738,16735,94764280,47682860,142447140,10.43,20.57,31
2020,3,07,19,3,29,충청남도,63600,2814,66414,551565880,22689460,574255340,9,16.43,25
2020,3,07,26,4,30,충청남도,37623,5668,43291,323200200,42981660,366181860,6.14,22.86,29
2020,3,08,02,5,31,충청남도,54031,5463,59494,443809820,40713080,484522900,6.14,19.71,26
2020,3,08,09,1,32,충청남도,88878,6900,95778,766072620,52402100,818474720,5,15,20
2020,3,08,16,2,33,충청남도,86604,6877,93481,764634860,53882900,818517760,6.71,16.86,24
2020,3,08,23,3,34,충청남도,35810,8255,44065,311187690,68718860,379906550,7,17.86,25
2020,3,08,30,4,35,충청남도,7672,15982,23654,64360060,136216440,200576500,6.71,13.86,21
2020,3,09,06,1,36,충청남도,7790,12127,19917,62553130,97937030,160490160,6.86,9.29,16
2020,3,09,13,2,37,충청남도,5862,10645,16507,49930020,87246340,137176360,5.43,10.29,16
2020,3,09,20,3,38,충청남도,3628,10999,14627,30094430,94752950,124847380,7.14,13.57,21
2020,3,09,27,4,39,충청남도,11390,7736,19126,95415940,65622130,161038070,7.43,12,19
2020,4,10,04,1,40,충청남도,61229,14625,75854,541313460,123697290,665010750,10.43,11.86,22
2020,4,10,11,2,41,충청남도,22491,8031,30522,198574900,68583080,267157980,10.43,12,22
2020,4,10,18,3,42,충청남도,19374,4747,24121,169932030,34973150,204905180,12.43,14.29,27
2020,4,10,25,4,43,충청남도,23813,3736,27549,200852910,27143550,227996460,9.86,14.86,25
2020,4,11,01,5,44,충청남도,25498,3766,29264,221516470,30291640,251808110,11,14.86,26
2020,4,11,08,1,45,충청남도,26856,2254,29110,238661170,18392270,257053440,9.71,15.14,25
2020,4,11,15,2,46,충청남도,22774,2371,25145,200836240,18682760,219519000,9.14,18.71,28
2020,4,11,22,3,47,충청남도,16487,5424,21911,143844210,46358140,190202350,9.43,20.71,30
2020,4,11,29,4,48,충청남도,12168,4471,16639,101411800,37752550,139164350,8.29,22.86,31
2020,4,12,06,1,49,충청남도,7970,3011,10981,66022840,26166410,92189250,10.29,23.71,34
2020,4,12,13,2,50,충청남도,6079,1819,7898,53210990,15695210,68906200,12.86,19.29,32
2020,4,12,20,3,51,충청남도,4429,1760,6189,38142240,15348670,53490910,9.86,22.57,32
2020,4,12,27,4,52,충청남도,2481,11373,13854,21289320,97556690,118846010,6.14,18.57,25
2021,1,01,03,5,53,충청남도,1587,7515,9102,12911020,62583580,75494600,5.86,22.14,28
2020,1,01,05,1,1,충청북도,104535,32807,137342,866100380,270096200,1136196580,4.57,12.86,17
2020,1,01,12,2,2,충청북도,32064,41324,73388,261946380,339472520,601418900,5.29,15.29,21
2020,1,01,19,3,3,충청북도,35781,28505,64286,290834900,232012820,522847720,6.43,14.71,21
2020,1,01,26,4,4,충청북도,131000,14747,145747,1128871020,116806740,1245677760,7.43,13.57,21
2020,1,02,02,5,5,충청북도,86805,11108,97913,696039580,83954600,779994180,8.86,14.86,24
2020,1,02,09,1,6,충청북도,41234,9571,50805,339648420,75982820,415631240,7.86,10.14,18
2020,1,02,16,2,7,충청북도,51651,18293,69944,422651320,144619540,567270860,7.57,11,19
2020,1,02,23,3,8,충청북도,27515,13261,40776,224098200,105150440,329248640,7,11.29,18
2020,1,03,01,4,9,충청북도,5772,9425,15197,46535120,76118180,122653300,6.71,12.86,20
2020,1,03,08,1,10,충청북도,2988,10039,13027,25231580,82378200,107609780,5.71,21.43,27
2020,1,03,15,2,11,충청북도,1745,9112,10857,13763540,73620220,87383760,5.57,27.43,33
2020,1,03,22,3,12,충청북도,1107,5979,7086,8113160,47494740,55607900,5.86,28.71,35
2020,1,03,29,4,13,충청북도,900,4914,5814,6451760,37133780,43585540,7.29,25.86,33
2020,2,04,05,1,14,충청북도,409,3323,3732,2862940,27010960,29873900,7.71,22,30
2020,2,04,12,2,15,충청북도,276,2865,3141,2264600,23418200,25682800,6.29,22,28
2020,2,04,19,3,16,충청북도,893,3274,4167,7742480,24759120,32501600,5,22.57,28
2020,2,04,26,4,17,충청북도,543,2824,3367,4627080,19495880,24122960,3.57,26.14,30
2020,2,05,03,5,18,충청북도,2690,6535,9225,21244580,48009320,69253900,7.14,21.86,29
2020,2,05,10,1,19,충청북도,2303,6632,8935,19070660,52563760,71634420,7.29,17.71,25
2020,2,05,17,2,20,충청북도,709,4163,4872,5994860,35578600,41573460,5.71,18.57,24
2020,2,05,24,3,21,충청북도,374,5107,5481,3012520,41127800,44140320,5.57,23.43,29
2020,2,05,31,4,22,충청북도,604,6202,6806,4321000,47601940,51922940,5.86,21.29,27
2020,2,06,07,1,23,충청북도,8853,4799,13652,78386260,37176640,115562900,5.43,20.43,26
2020,2,06,14,2,24,충청북도,14699,4029,18728,131970580,31702800,163673380,5.43,16.57,22
2020,2,06,21,3,25,충청북도,13701,5188,18889,119605140,42307560,161912700,6.29,12.86,19
2020,2,06,28,4,26,충청북도,37211,4226,41437,305812820,32548580,338361400,6,12.29,18
2020,3,07,05,1,27,충청북도,19633,3286,22919,165055720,25197800,190253520,7.14,15.57,23
2020,3,07,12,2,28,충청북도,9362,4844,14206,80007480,39810440,119817920,6.86,18.71,26
2020,3,07,19,3,29,충청북도,55066,2429,57495,468961540,19797180,488758720,7.57,16.14,24
2020,3,07,26,4,30,충청북도,32377,4631,37008,273762360,35124180,308886540,8.43,17.71,26
2020,3,08,02,5,31,충청북도,45719,4193,49912,367874800,31420460,399295260,6.86,17.29,24
2020,3,08,09,1,32,충청북도,81824,5420,87244,689916280,41059900,730976180,7,14,21
2020,3,08,16,2,33,충청북도,74172,4745,78917,640943420,37165960,678109380,5.71,11.29,17
2020,3,08,23,3,34,충청북도,34093,7986,42079,290317650,65953140,356270790,7.57,13.71,21
2020,3,08,30,4,35,충청북도,7761,15531,23292,63123840,126813490,189937330,8.57,8.43,17
2020,3,09,06,1,36,충청북도,7817,11438,19255,62138250,96080320,158218570,8,7.43,15
2020,3,09,13,2,37,충청북도,5757,8592,14349,48459570,72053800,120513370,6.71,9.57,16
2020,3,09,20,3,38,충청북도,3636,9250,12886,29734850,77622750,107357600,8.14,11.29,19
2020,3,09,27,4,39,충청북도,8770,6003,14773,73036620,49260030,122296650,8.14,9.71,18
2020,4,10,04,1,40,충청북도,51294,11624,62918,437406120,95349480,532755600,13,10.86,24
2020,4,10,11,2,41,충청북도,18205,6291,24496,156298390,52016870,208315260,10.86,12,23
2020,4,10,18,3,42,충청북도,14603,2902,17505,125719710,24145840,149865550,9.57,12.14,22
2020,4,10,25,4,43,충청북도,20687,2415,23102,175265610,19023640,194289250,9.71,14.43,24
2020,4,11,01,5,44,충청북도,21267,2200,23467,182184500,17772770,199957270,10.71,14,25
2020,4,11,08,1,45,충청북도,26430,1554,27984,235642740,12512750,248155490,8,12.57,21
2020,4,11,15,2,46,충청북도,21484,2103,23587,191158140,16312130,207470270,8,16.43,24
2020,4,11,22,3,47,충청북도,15898,4337,20235,138149550,37364810,175514360,10.43,19.43,30
2020,4,11,29,4,48,충청북도,10661,3629,14290,85377900,30013700,115391600,8.71,21.71,30
2020,4,12,06,1,49,충청북도,5609,2438,8047,47614770,20621820,68236590,7.57,20.29,28
2020,4,12,13,2,50,충청북도,4166,1376,5542,36287220,11620090,47907310,6.86,16.29,23
2020,4,12,20,3,51,충청북도,2880,1059,3939,24959190,8890020,33849210,5.43,19,24
2020,4,12,27,4,52,충청북도,1868,7368,9236,16055450,63623840,79679290,4.43,16.43,21
2021,1,01,03,5,53,충청북도,1158,4581,5739,9565520,38576590,48142110,4.43,16.29,21
2021,1,01,10,1,1,강원도,396,1730,2126,3734080,15084950,18819030,4.71,14.29,19
2021,1,01,17,2,2,강원도,284,1960,2244,2718390,16730410,19448800,4.14,19.57,24
2021,1,01,24,3,3,강원도,100,9004,9104,806790,77410470,78217260,3.14,22.14,25
2021,1,01,31,4,4,강원도,1379,15593,16972,10413330,131240660,141653990,4.29,18.43,23
2021,1,02,07,1,5,강원도,865,15631,16496,7066260,141437530,148503790,4.86,16.71,22
2021,1,02,14,2,6,강원도,3527,14816,18343,30939480,137491930,168431410,5.86,17.57,23
2021,1,02,21,3,7,강원도,5695,8349,14044,49336090,77129620,126465710,7.57,19.57,27
2021,1,02,28,4,8,강원도,4360,10357,14717,37935500,90851620,128787120,9.43,20.71,30
2021,1,03,07,1,9,강원도,2474,15420,17894,21681880,137792360,159474240,7.14,17.14,24
2021,1,03,14,2,10,강원도,841,13282,14123,7131560,117043500,124175060,4.43,17.71,22
2021,1,03,21,3,11,강원도,647,12300,12947,5352920,108494230,113847150,5.57,21.14,27
2021,1,03,28,4,12,강원도,3418,13909,17327,28845920,122357370,151203290,10.29,20,30
2021,2,04,04,1,13,강원도,5227,9479,14706,41937390,83333600,125270990,9.29,16.43,26
2021,2,04,11,2,14,강원도,2575,6781,9356,21650470,62831140,84481610,8.14,16.14,24
2021,2,04,18,3,15,강원도,5844,6076,11920,51818830,56155910,107974740,6.43,14.86,21
2021,2,04,25,4,16,강원도,6201,5541,11742,54581060,50581070,105162130,7,17.43,24
2021,2,05,02,5,17,강원도,7964,8592,16556,67612980,71996900,139609880,6.71,17.14,24
2021,2,05,09,1,18,강원도,6039,12275,18314,52841780,102506990,155348770,8.71,17.14,26
2021,2,05,16,2,19,강원도,3361,7051,10412,29431820,62999830,92431650,10.14,20.71,31
2021,2,05,23,3,20,강원도,1822,25984,27806,15277460,240742420,256019880,9.57,17.43,27
2021,2,05,30,4,21,강원도,2439,19930,22369,19692560,175956220,195648780,6.57,15.86,22
2021,2,06,06,1,22,강원도,1340,21622,22962,11021190,198720800,209741990,7.29,15.43,23
2021,2,06,13,2,23,강원도,671,19078,19749,4958500,177319150,182277650,6,14.14,20
2021,2,06,20,3,24,강원도,2123,21971,24094,17955140,202996510,220951650,5.29,13.57,19
2021,2,06,27,4,25,강원도,8889,16872,25761,79512370,156137480,235649850,5.86,13.14,19
2021,3,07,04,1,26,강원도,12599,14844,27443,108573230,132159740,240732970,8.29,13.86,22
2021,3,07,11,2,27,강원도,6281,35188,41469,57841370,331098490,388939860,8.14,11.43,20
2021,3,07,18,3,28,강원도,14714,23608,38322,143799880,223184290,366984170,7,13,20
2021,3,07,25,4,29,강원도,5509,23299,28808,51122070,206624680,257746750,6.71,14.43,21
2021,3,08,01,5,30,강원도,20545,16255,36800,181543680,136090200,317633880,5.86,11.43,17
2021,3,08,08,1,31,강원도,22752,17212,39964,208268150,152556190,360824340,4.43,12,16
2021,3,08,15,2,32,강원도,42865,9844,52709,389481110,86540520,476021630,5.71,12,18
2021,3,08,22,3,33,강원도,47002,7261,54263,430821980,62286310,493108290,5.71,11,17
2021,3,08,29,4,34,강원도,31278,3539,34817,276571610,28270510,304842120,6.43,13.86,20
2021,3,09,05,1,35,강원도,15279,18096,33375,138571090,169409370,307980460,6.57,13.14,20
2021,3,09,12,2,36,강원도,9037,12147,21184,85057110,112365840,197422950,9.29,13,22
2021,3,09,19,3,37,강원도,14450,10008,24458,128726450,92006410,220732860,7.86,12,20
2021,3,09,26,4,38,강원도,21929,12072,34001,202303250,110640630,312943880,6.57,12.29,19
2021,4,10,03,5,39,강원도,7754,12989,20743,70296580,114432020,184728600,6.29,12.14,18
2021,4,10,10,1,40,강원도,7049,12005,19054,61850220,108219250,170069470,8.14,12,20
2021,4,10,17,2,41,강원도,4216,30708,34924,36204670,283817440,320022110,9.43,13.71,23
2021,4,10,24,3,42,강원도,2740,22263,25003,22229770,206728810,228958580,9.43,13.57,23
2021,4,10,31,4,43,강원도,1567,21505,23072,11108000,192365090,203473090,6.57,12,19
2021,4,11,07,1,44,강원도,772,49812,50584,5979000,470867550,476846550,6.29,14.14,20
2021,4,11,14,2,45,강원도,7642,33341,40983,71104180,304667200,375771380,6.71,16.29,23
2021,4,11,21,3,46,강원도,12674,18239,30913,117560970,166625070,284186040,6.29,17.29,24
2021,4,11,28,4,47,강원도,17970,12387,30357,159314760,108411810,267726570,9.86,15.57,25
2021,4,12,05,1,48,강원도,13468,9928,23396,120717350,88639770,209357120,12.14,14.86,27
2021,4,12,12,2,49,강원도,8352,7251,15603,75406800,63634630,139041430,12,17.43,29
2021,4,12,19,3,50,강원도,2608,66787,69395,23424720,641359630,664784350,10,14.86,25
2021,4,12,26,4,51,강원도,953,58060,59013,7940110,550900270,558840380,6.43,12.71,19
2022,1,01,02,5,52,강원도,4327,33662,37989,37196300,310136550,347332850,3.71,12.43,16
2021,1,01,10,1,1,경기도,4546,24946,29492,40690060,223593710,264283770,7.14,31.57,39
2021,1,01,17,2,2,경기도,3117,26521,29638,27965090,233464910,261430000,8,35.86,44
2021,1,01,24,3,3,경기도,1949,124580,126529,15448130,1147113180,1162561310,9.43,38,47
2021,1,01,31,4,4,경기도,13966,191747,205713,116556390,1708472480,1825028870,10.43,34.14,45
2021,1,02,07,1,5,경기도,8226,168067,176293,69310580,1596178740,1665489320,10,29.57,40
2021,1,02,14,2,6,경기도,39489,182490,221979,370807200,1750692790,2121499990,9.57,31.86,41
2021,1,02,21,3,7,경기도,54848,100498,155346,507665270,969277710,1476942980,13,38.71,52
2021,1,02,28,4,8,경기도,39617,130586,170203,353972870,1190715340,1544688210,15.71,46.57,62
2021,1,03,07,1,9,경기도,20535,192788,213323,195554090,1837323110,2032877200,12.86,38.57,51
2021,1,03,14,2,10,경기도,5113,149276,154389,48333200,1420583620,1468916820,7,34.14,41
2021,1,03,21,3,11,경기도,5301,140285,145586,62295070,1340650730,1402945800,8,36,44
2021,1,03,28,4,12,경기도,29628,167341,196969,267799580,1598091160,1865890740,15.43,36,51
2021,2,04,04,1,13,경기도,48485,113179,161664,427779770,1054068920,1481848690,22.14,36.86,59
2021,2,04,11,2,14,경기도,26526,79314,105840,243903140,781606980,1025510120,22,33.57,56
2021,2,04,18,3,15,경기도,66433,71413,137846,642765130,694475650,1337240780,18.57,30.71,49
2021,2,04,25,4,16,경기도,67324,64585,131909,633517950,623812350,1257330300,16.43,30.14,47
2021,2,05,02,5,17,경기도,86060,99011,185071,774375330,889917620,1664292950,17.71,32.14,50
2021,2,05,09,1,18,경기도,64218,140616,204834,628703470,1308032590,1936736060,17.71,30.57,48
2021,2,05,16,2,19,경기도,30445,76079,106524,295953900,730836900,1026790800,17.43,33,50
2021,2,05,23,3,20,경기도,14860,339273,354133,140294170,3344575630,3484869800,17.86,33.43,51
2021,2,05,30,4,21,경기도,22838,254328,277166,205538880,2393958550,2599497430,15.71,33.71,49
2021,2,06,06,1,22,경기도,10441,270044,280485,94901610,2679327500,2774229110,13.14,29.57,43
2021,2,06,13,2,23,경기도,4037,229031,233068,36595540,2278000930,2314596470,10.71,27.29,38
2021,2,06,20,3,24,경기도,16613,264128,280741,151533100,2611052590,2762585690,9.71,26.86,37
2021,2,06,27,4,25,경기도,86679,216043,302722,849475230,2136205850,2985681080,13.29,25.43,39
2021,3,07,04,1,26,경기도,113847,187873,301720,1084213360,1794823910,2879037270,12.29,23.86,36
2021,3,07,11,2,27,경기도,51172,419315,470487,516426960,4236293640,4752720600,11,23.57,35
2021,3,07,18,3,28,경기도,116717,231471,348188,1221773190,2349075010,3570848200,7.86,20.14,28
2021,3,07,25,4,29,경기도,51127,240994,292121,536141060,2380234440,2916375500,12,24,36
2021,3,08,01,5,30,경기도,217599,181537,399136,2071701030,1686090990,3757792020,11.57,21.86,33
2021,3,08,08,1,31,경기도,232114,186951,419065,2308597440,1843978980,4152576420,9.29,20.14,29
2021,3,08,15,2,32,경기도,366222,96747,462969,3597503430,971910630,4569414060,9.43,21,30
2021,3,08,22,3,33,경기도,445831,77210,523041,4433204470,762936530,5196141000,9.29,21,30
2021,3,08,29,4,34,경기도,276152,40468,316620,2686214190,381556160,3067770350,11.14,24,35
2021,3,09,05,1,35,경기도,142014,225173,367187,1375600250,2269195390,3644795640,8.86,28.71,38
2021,3,09,12,2,36,경기도,84643,149692,234335,842785070,1512954870,2355739940,12,28.71,41
2021,3,09,19,3,37,경기도,147838,113555,261393,1460833710,1112599110,2573432820,12.71,23.57,36
2021,3,09,26,4,38,경기도,236588,127443,364031,2354164940,1270176370,3624341310,11.71,23.71,35
2021,4,10,03,5,39,경기도,66596,164163,230759,623664890,1577123890,2200788780,13.57,25.71,39
2021,4,10,10,1,40,경기도,60622,135883,196505,594182410,1355700290,1949882700,12.71,23.14,36
2021,4,10,17,2,41,경기도,37098,334459,371557,354000920,3371526910,3725527830,15,21.57,37
2021,4,10,24,3,42,경기도,27970,268790,296760,225909280,2769038700,2994947980,19.14,21.86,41
2021,4,10,31,4,43,경기도,13486,220063,233549,112631070,2193623150,2306254220,18,25.14,43
2021,4,11,07,1,44,경기도,4187,530836,535023,38339960,5620322810,5658662770,12.14,22.57,35
2021,4,11,14,2,45,경기도,46165,308065,354230,479178510,3226445770,3705624280,13.57,25.57,39
2021,4,11,21,3,46,경기도,100682,187085,287767,1042610460,1963957500,3006567960,14.14,27.86,42
2021,4,11,28,4,47,경기도,177694,147433,325127,1756955200,1459077360,3216032560,17.43,25.14,43
2021,4,12,05,1,48,경기도,120993,114608,235601,1235688919,1170710499,2406399418,20.43,25.71,46
2021,4,12,12,2,49,경기도,70053,76346,146399,737764230,777055069,1514819299,20.71,28.71,49
2021,4,12,19,3,50,경기도,22936,780689,803625,225684890,7951587490,8177272380,16,26,42
2021,4,12,26,4,51,경기도,6978,717629,724607,69159640,7290918590,7360078230,8.86,23.71,33
2022,1,01,02,5,52,경기도,47024,455083,502107,447887140,4494201290,4942088430,9.14,19.57,29
2021,1,01,10,1,1,경상남도,1016,4408,5424,9045340,38786120,47831460,6.43,16.71,23
2021,1,01,17,2,2,경상남도,701,4306,5007,6299540,37488810,43788350,5.71,20.57,26
2021,1,01,24,3,3,경상남도,261,19803,20064,2295050,173307390,175602440,5.71,20.43,26
2021,1,01,31,4,4,경상남도,2675,29277,31952,22340020,247689760,270029780,5.14,17.14,22
2021,1,02,07,1,5,경상남도,1669,32184,33853,14098520,290879650,304978170,5.14,16,21
2021,1,02,14,2,6,경상남도,9904,35546,45450,90220190,328392690,418612880,6,14,20
2021,1,02,21,3,7,경상남도,14099,17556,31655,126441140,160462880,286904020,8.14,17,25
2021,1,02,28,4,8,경상남도,11005,24311,35316,96380470,212089920,308470390,9.57,19.14,29
2021,1,03,07,1,9,경상남도,5662,33619,39281,51619290,301450490,353069780,6.57,17.86,24
2021,1,03,14,2,10,경상남도,1495,24015,25510,14029570,216029770,230059340,4.43,19.14,24
2021,1,03,21,3,11,경상남도,935,22406,23341,9980470,201264140,211244610,6.57,24,31
2021,1,03,28,4,12,경상남도,4619,30080,34699,40399480,269228790,309628270,10.29,19.71,30
2021,2,04,04,1,13,경상남도,9823,22983,32806,83326470,201514360,284840830,8.86,16.43,25
2021,2,04,11,2,14,경상남도,5827,15393,21220,49967110,143463280,193430390,7.71,18.43,26
2021,2,04,18,3,15,경상남도,13440,11805,25245,122198700,107016260,229214960,8.14,14.86,23
2021,2,04,25,4,16,경상남도,14328,10972,25300,128267410,99582480,227849890,7.71,18.14,26
2021,2,05,02,5,17,경상남도,17238,16448,33686,148179900,140975690,289155590,8.29,20.71,29
2021,2,05,09,1,18,경상남도,13190,23805,36995,118014380,208015630,326030010,9.29,18.71,28
2021,2,05,16,2,19,경상남도,6259,14308,20567,56056930,128209620,184266550,10.14,18.86,29
2021,2,05,23,3,20,경상남도,2082,70176,72258,17972760,644041050,662013810,8.86,19.71,29
2021,2,05,30,4,21,경상남도,5364,48440,53804,45149820,427118490,472268310,7.71,17.57,25
2021,2,06,06,1,22,경상남도,2719,52101,54820,23668540,475288150,498956690,7.29,16,23
2021,2,06,13,2,23,경상남도,705,43839,44544,5963940,400314670,406278610,6,16.14,22
2021,2,06,20,3,24,경상남도,3830,47273,51103,33150650,431718230,464868880,4.43,16.71,21
2021,2,06,27,4,25,경상남도,23972,36273,60245,219210960,331006060,550217020,6.14,16.43,23
2021,3,07,04,1,26,경상남도,36153,33025,69178,320721290,296149430,616870720,8.71,17.57,26
2021,3,07,11,2,27,경상남도,14957,82901,97858,142695820,780278270,922974090,8.29,16.57,25
2021,3,07,18,3,28,경상남도,29228,51654,80882,289434330,488399500,777833830,6.29,14.86,21
2021,3,07,25,4,29,경상남도,11518,47695,59213,114609140,440131850,554740990,6.57,18,25
2021,3,08,01,5,30,경상남도,50936,32405,83341,457412290,277808400,735220690,5.57,14.71,20
2021,3,08,08,1,31,경상남도,56357,36067,92424,526694520,325950960,852645480,5,12.14,17
2021,3,08,15,2,32,경상남도,85121,15730,100851,789705080,142856210,932561290,5,9.29,14
2021,3,08,22,3,33,경상남도,96114,11000,107114,902346500,98940380,1001286880,3.57,9.43,13
2021,3,08,29,4,34,경상남도,61313,5725,67038,564645790,49850010,614495800,4.43,10.29,15
2021,3,09,05,1,35,경상남도,32051,38492,70543,294858180,360379160,655237340,5.57,12.86,18
2021,3,09,12,2,36,경상남도,17987,25438,43425,168780440,238561250,407341690,7.71,14.71,22
2021,3,09,19,3,37,경상남도,36301,20620,56921,336780970,189192960,525973930,7.71,13.86,22
2021,3,09,26,4,38,경상남도,59650,23361,83011,566750230,218812590,785562820,5.57,12.14,18
2021,4,10,03,5,39,경상남도,16533,33498,50031,149052650,303045880,452098530,6.29,10.86,17
2021,4,10,10,1,40,경상남도,13742,25463,39205,128420530,237422170,365842700,8.43,12.86,21
2021,4,10,17,2,41,경상남도,9891,70808,80699,88821940,663857570,752679510,11,17.71,29
2021,4,10,24,3,42,경상남도,4029,44408,48437,34610670,421414540,456025210,11.43,14.86,26
2021,4,10,31,4,43,경상남도,2457,36116,38573,20289070,328597710,348886780,9.43,14.86,24
2021,4,11,07,1,44,경상남도,934,93353,94287,6855560,915169620,922025180,5.43,16.14,22
2021,4,11,14,2,45,경상남도,11765,54907,66672,115032190,533667010,648699200,6.57,12.29,19
2021,4,11,21,3,46,경상남도,22844,30355,53199,223009500,289700610,512710110,7.71,15.14,23
2021,4,11,28,4,47,경상남도,38026,21493,59519,356454140,196710890,553165030,7.29,14.57,22
2021,4,12,05,1,48,경상남도,26132,18424,44556,251466910,167746020,419212930,11.29,15.86,27
2021,4,12,12,2,49,경상남도,14961,11926,26887,146942620,111186720,258129340,12.43,18.14,31
2021,4,12,19,3,50,경상남도,5247,134607,139854,47806250,1279489490,1327295740,10.43,16.14,27
2021,4,12,26,4,51,경상남도,1132,115853,116985,10350100,1090486170,1100836270,4.71,13.43,18
2022,1,01,02,5,52,경상남도,9188,73348,82536,79969210,668598720,748567930,5.29,11.86,17
2021,1,01,10,1,1,경상북도,506,1793,2299,4525400,15683000,20208400,6.57,13,20
2021,1,01,17,2,2,경상북도,304,1732,2036,2667030,15246810,17913840,5.86,16.14,22
2021,1,01,24,3,3,경상북도,131,8552,8683,941070,74591300,75532370,5.57,16,22
2021,1,01,31,4,4,경상북도,1142,15396,16538,9331870,133740970,143072840,6.29,14.29,21
2021,1,02,07,1,5,경상북도,941,16067,17008,7368660,144896600,152265260,6.43,13.14,20
2021,1,02,14,2,6,경상북도,5042,18018,23060,44934240,164717480,209651720,6.86,14,21
2021,1,02,21,3,7,경상북도,7793,9732,17525,68504290,87758870,156263160,7.57,17.29,25
2021,1,02,28,4,8,경상북도,6671,13051,19722,56493650,112227720,168721370,7.86,16.29,24
2021,1,03,07,1,9,경상북도,3387,18624,22011,30294660,165975460,196270120,5.43,13.86,19
2021,1,03,14,2,10,경상북도,1123,14637,15760,9785780,131071170,140856950,4,16.14,20
2021,1,03,21,3,11,경상북도,700,14511,15211,6682830,127410790,134093620,5.14,19.29,24
2021,1,03,28,4,12,경상북도,2122,18202,20324,18854820,161804430,180659250,8.14,18.29,26
2021,2,04,04,1,13,경상북도,5181,13641,18822,44342460,119160660,163503120,7.57,15.29,23
2021,2,04,11,2,14,경상북도,3072,9457,12529,27030200,87262780,114292980,7.86,14.57,22
2021,2,04,18,3,15,경상북도,8226,7749,15975,75456040,71665430,147121470,6.14,14.57,21
2021,2,04,25,4,16,경상북도,8717,7883,16600,79526440,72060280,151586720,7,15.43,22
2021,2,05,02,5,17,경상북도,10954,9723,20677,96206620,84885360,181091980,8.29,15.14,23
2021,2,05,09,1,18,경상북도,8701,15115,23816,78661410,131829590,210491000,8.57,13.43,22
2021,2,05,16,2,19,경상북도,4520,9377,13897,41055460,83421030,124476490,7.86,14.71,23
2021,2,05,23,3,20,경상북도,1732,44856,46588,14631720,413049220,427680940,7.43,15.29,23
2021,2,05,30,4,21,경상북도,3593,30275,33868,30368940,266922640,297291580,6.14,14,20
2021,2,06,06,1,22,경상북도,1483,35477,36960,12992730,329148400,342141130,7.14,12.86,20
2021,2,06,13,2,23,경상북도,374,28532,28906,3068440,264965290,268033730,6.29,13.71,20
2021,2,06,20,3,24,경상북도,2772,30367,33139,23466640,284433190,307899830,4.71,13.57,18
2021,2,06,27,4,25,경상북도,14225,23338,37563,133524940,217541200,351066140,6.14,14.86,21
2021,3,07,04,1,26,경상북도,19610,19080,38690,176341960,171646730,347988690,8,16.14,24
2021,3,07,11,2,27,경상북도,12100,54280,66380,114812240,518772640,633584880,7.86,13.57,21
2021,3,07,18,3,28,경상북도,23353,37200,60553,232984250,355030650,588014900,7.43,13,20
2021,3,07,25,4,29,경상북도,9657,38241,47898,96062080,353189070,449251150,8.86,14.14,23
2021,3,08,01,5,30,경상북도,37569,25735,63304,346182270,223795190,569977460,7.43,11.43,19
2021,3,08,08,1,31,경상북도,39625,25870,65495,379046200,236339560,615385760,6.57,10.86,17
2021,3,08,15,2,32,경상북도,65775,11951,77726,625920680,110080350,736001030,6.86,11,18
2021,3,08,22,3,33,경상북도,74204,7885,82089,719474060,71786810,791260870,7.14,11,18
2021,3,08,29,4,34,경상북도,51124,3416,54540,454868260,29839980,484708240,7,12.57,20
2021,3,09,05,1,35,경상북도,29020,25269,54289,226806970,240629630,467436600,7.43,13.86,21
2021,3,09,12,2,36,경상북도,13437,16343,29780,130494070,155619320,286113390,9.29,14.43,24
2021,3,09,19,3,37,경상북도,26660,14815,41475,255173150,136803700,391976850,9.29,12.29,22
2021,3,09,26,4,38,경상북도,43260,16998,60258,428137010,161052200,589189210,7.43,11.57,19
2021,4,10,03,5,39,경상북도,12501,21682,34183,114022450,195455640,309478090,8.14,14.43,23
2021,4,10,10,1,40,경상북도,10945,17107,28052,103346190,162831510,266177700,10.14,13.14,23
2021,4,10,17,2,41,경상북도,7928,46787,54715,72472650,447381520,519854170,12.43,15,27
2021,4,10,24,3,42,경상북도,3348,30628,33976,29013640,292114320,321127960,11.57,13.86,25
2021,4,10,31,4,43,경상북도,1975,24427,26402,15680600,223052190,238732790,9.29,13.86,23
2021,4,11,07,1,44,경상북도,1222,59878,61100,8870240,587852490,596722730,8.14,13,21
2021,4,11,14,2,45,경상북도,9571,37180,46751,96728040,358641900,455369940,9.14,12.29,21
2021,4,11,21,3,46,경상북도,16600,21614,38214,164615410,202272120,366887530,6.86,17.14,24
2021,4,11,28,4,47,경상북도,26488,16541,43029,247872990,145433610,393306600,8.14,17.29,25
2021,4,12,05,1,48,경상북도,18255,11588,29843,175714460,104265480,279979940,12.86,16,29
2021,4,12,12,2,49,경상북도,11142,7617,18759,104160460,67988950,172149410,14.71,15.71,30
2021,4,12,19,3,50,경상북도,4365,85386,89751,36479860,815551840,852031700,10.86,13.14,24
2021,4,12,26,4,51,경상북도,1167,80350,81517,8987300,765705570,774692870,6.57,12.71,19
2022,1,01,02,5,52,경상북도,6630,49437,56067,58728310,457989530,516717840,7.43,11.71,19
2021,1,01,10,1,1,광주광역시,1203,3400,4603,11084240,30420220,41504460,7.86,16.86,25
2021,1,01,17,2,2,광주광역시,935,3585,4520,8495070,32044920,40539990,8.14,21.86,30
2021,1,01,24,3,3,광주광역시,568,14484,15052,4794130,129323410,134117540,8.43,24.14,33
2021,1,01,31,4,4,광주광역시,1656,20390,22046,14544150,168049240,182593390,7.71,21.43,29
2021,1,02,07,1,5,광주광역시,1116,18870,19986,10037340,171962620,181999960,6.71,16.29,23
2021,1,02,14,2,6,광주광역시,7852,21497,29349,75316080,198201890,273517970,7.86,18,26
2021,1,02,21,3,7,광주광역시,10074,11903,21977,90661100,109049810,199710910,9.57,20.43,30
2021,1,02,28,4,8,광주광역시,9079,14981,24060,78608370,131583160,210191530,10.43,23.57,34
2021,1,03,07,1,9,광주광역시,5052,19301,24353,47431970,176750340,224182310,8.14,20.43,29
2021,1,03,14,2,10,광주광역시,1804,16523,18327,16723710,151918630,168642340,5.29,22.57,28
2021,1,03,21,3,11,광주광역시,1859,16936,18795,20067340,154307420,174374760,6.43,25.14,32
2021,1,03,28,4,12,광주광역시,6144,20457,26601,52703220,186316210,239019430,11.86,21.86,34
2021,2,04,04,1,13,광주광역시,7991,16074,24065,68913570,144578330,213491900,12.29,20.43,33
2021,2,04,11,2,14,광주광역시,4369,11464,15833,39947260,108090730,148037990,11.43,19.71,31
2021,2,04,18,3,15,광주광역시,10529,9290,19819,96231250,86345400,182576650,9.43,16.71,26
2021,2,04,25,4,16,광주광역시,11125,7529,18654,100031940,68100100,168132040,9.14,16.86,26
2021,2,05,02,5,17,광주광역시,14024,11092,25116,121461360,95281870,216743230,8.86,18.86,28
2021,2,05,09,1,18,광주광역시,9432,14943,24375,88298640,130554560,218853200,11.71,15.71,27
2021,2,05,16,2,19,광주광역시,6270,9330,15600,56842580,85404560,142247140,14.43,17.71,32
2021,2,05,23,3,20,광주광역시,3172,46797,49969,27122600,440050970,467173570,11.86,19.71,32
2021,2,05,30,4,21,광주광역시,3925,30051,33976,33110960,272220770,305331730,10.71,19.57,30
2021,2,06,06,1,22,광주광역시,2200,36483,38683,19266630,339133920,358400550,9.71,14.71,24
2021,2,06,13,2,23,광주광역시,1177,31239,32416,9415400,290024640,299440040,8.29,13.71,22
2021,2,06,20,3,24,광주광역시,3210,35833,39043,27578630,334401940,361980570,7.57,13.71,21
2021,2,06,27,4,25,광주광역시,16090,29190,45280,145651840,273559100,419210940,9.57,13.43,23
2021,3,07,04,1,26,광주광역시,21060,23961,45021,183405470,216165660,399571130,9.86,15.86,26
2021,3,07,11,2,27,광주광역시,10981,57491,68472,100283430,567531580,667815010,10.29,12.57,23
2021,3,07,18,3,28,광주광역시,23554,38697,62251,230573400,377401670,607975070,8.71,13.57,22
2021,3,07,25,4,29,광주광역시,10263,37048,47311,99738180,344036980,443775160,10.14,16.43,27
2021,3,08,01,5,30,광주광역시,36502,24368,60870,336688050,215562970,552251020,8.57,12.86,21
2021,3,08,08,1,31,광주광역시,41019,26622,67641,392357930,250349580,642707510,8.14,13,21
2021,3,08,15,2,32,광주광역시,69855,14103,83958,656670080,134147520,790817600,7.43,13.29,21
2021,3,08,22,3,33,광주광역시,77809,9254,87063,731467450,87071090,818538540,7.29,10.71,18
2021,3,08,29,4,34,광주광역시,49949,4445,54394,459557550,40165720,499723270,8.86,13.71,23
2021,3,09,05,1,35,광주광역시,24355,28751,53106,223334050,284207650,507541700,7.86,13.43,21
2021,3,09,12,2,36,광주광역시,13908,19198,33106,130263740,188670440,318934180,10.14,15,25
2021,3,09,19,3,37,광주광역시,26251,14846,41097,252395940,139086850,391482790,11,14.14,25
2021,3,09,26,4,38,광주광역시,38502,15522,54024,368542040,149311130,517853170,9.29,13.14,22
2021,4,10,03,5,39,광주광역시,12864,21926,34790,115753080,203652620,319405700,10.43,12.86,23
2021,4,10,10,1,40,광주광역시,11177,17822,28999,104802490,169103160,273905650,12.57,13,26
2021,4,10,17,2,41,광주광역시,7271,48895,56166,66986100,459070140,526056240,12.57,14.29,27
2021,4,10,24,3,42,광주광역시,3103,33050,36153,27419110,320382460,347801570,11.29,11.29,23
2021,4,10,31,4,43,광주광역시,2291,28118,30409,18559740,264449500,283009240,9,13.14,22
2021,4,11,07,1,44,광주광역시,799,65880,66679,6848320,703246370,710094690,7.14,15.57,23
2021,4,11,14,2,45,광주광역시,8906,39078,47984,93407270,410529590,503936860,8.57,14.86,23
2021,4,11,21,3,46,광주광역시,17249,23185,40434,183832050,233831570,417663620,11.29,15.57,27
2021,4,11,28,4,47,광주광역시,31420,15529,46949,312243570,151312870,463556440,14.29,15.29,30
2021,4,12,05,1,48,광주광역시,23070,12445,35515,232008420,126606190,358614610,15.71,15.86,32
2021,4,12,12,2,49,광주광역시,13831,10022,23853,139913910,96782240,236696150,15.86,19.29,35
2021,4,12,19,3,50,광주광역시,4915,87763,92678,47354820,868250170,915604990,10.86,17.29,28
2021,4,12,26,4,51,광주광역시,1627,87809,89436,15280090,880410030,895690120,6.86,13.14,20
2022,1,01,02,5,52,광주광역시,7781,51917,59698,67754980,499890110,567645090,4.71,13.71,18
2021,1,01,10,1,1,대구광역시,1279,5901,7180,11315350,51799750,63115100,9.29,23.29,33
2021,1,01,17,2,2,대구광역시,962,6065,7027,8548300,51932560,60480860,10,29,39
2021,1,01,24,3,3,대구광역시,559,24227,24786,4391620,217915850,222307470,9.29,27.71,37
2021,1,01,31,4,4,대구광역시,3935,37960,41895,30878220,324809220,355687440,9.57,28,38
2021,1,02,07,1,5,대구광역시,1920,35042,36962,16339840,319643770,335983610,7.57,24.29,32
2021,1,02,14,2,6,대구광역시,10332,36098,46430,94901820,334408130,429309950,8.86,25.71,35
2021,1,02,21,3,7,대구광역시,14710,19356,34066,134158590,177953320,312111910,11.14,30.43,42
2021,1,02,28,4,8,대구광역시,11605,26697,38302,102685720,233204360,335890080,12.14,32.57,45
2021,1,03,07,1,9,대구광역시,6214,35468,41682,60612600,327367660,387980260,8.86,23.86,33
2021,1,03,14,2,10,대구광역시,1879,29413,31292,17397840,270156250,287554090,6.86,25.71,33
2021,1,03,21,3,11,대구광역시,1810,27749,29559,19638950,255713580,275352530,6.71,28.57,35
2021,1,03,28,4,12,대구광역시,5903,31896,37799,52495850,292618880,345114730,13.14,28.14,41
2021,2,04,04,1,13,대구광역시,10763,23792,34555,92269540,211719640,303989180,14.57,23.57,38
2021,2,04,11,2,14,대구광역시,6094,17250,23344,53005010,162908120,215913130,13.29,21.71,35
2021,2,04,18,3,15,대구광역시,14236,14496,28732,133352130,134381720,267733850,11.29,22.57,34
2021,2,04,25,4,16,대구광역시,16443,12793,29236,151038500,120783230,271821730,9.14,22.29,31
2021,2,05,02,5,17,대구광역시,18338,20563,38901,164731220,179451540,344182760,10.86,28.29,39
2021,2,05,09,1,18,대구광역시,14199,26932,41131,136305700,243929100,380234800,11.57,24.29,36
2021,2,05,16,2,19,대구광역시,7986,17787,25773,75365820,165156510,240522330,13.43,23,36
2021,2,05,23,3,20,대구광역시,3301,76102,79403,30012840,718203750,748216590,13.71,19.86,34
2021,2,05,30,4,21,대구광역시,5304,52191,57495,46549410,469159560,515708970,11.43,22,33
2021,2,06,06,1,22,대구광역시,2273,50833,53106,20331700,484041360,504373060,10,22.71,33
2021,2,06,13,2,23,대구광역시,594,42310,42904,4978770,402181770,407160540,7.29,20.86,28
2021,2,06,20,3,24,대구광역시,3897,50835,54732,34012420,483773710,517786130,6.57,20.57,27
2021,2,06,27,4,25,대구광역시,21043,40626,61669,199848670,388272030,588120700,9,17.14,26
2021,3,07,04,1,26,대구광역시,25945,32370,58315,240272900,298822290,539095190,11.29,18.57,30
2021,3,07,11,2,27,대구광역시,15978,86680,102658,159176470,854939630,1014116100,10.29,17.43,28
2021,3,07,18,3,28,대구광역시,32084,56519,88603,326114460,561119410,887233870,8.43,15.57,24
2021,3,07,25,4,29,대구광역시,14171,53771,67942,142866720,510905170,653771890,10.14,18.57,29
2021,3,08,01,5,30,대구광역시,54844,36894,91738,508676560,331507520,840184080,8.29,14.57,23
2021,3,08,08,1,31,대구광역시,55663,37185,92848,544866750,353931910,898798660,6.86,15.43,22
2021,3,08,15,2,32,대구광역시,87179,18967,106146,846745800,182877730,1029623530,6.86,16.57,23
2021,3,08,22,3,33,대구광역시,98372,14352,112724,969095120,135416640,1104511760,7,14.43,21
2021,3,08,29,4,34,대구광역시,64080,8039,72119,614334430,73301470,687635900,9,17.29,26
2021,3,09,05,1,35,대구광역시,31451,42775,74226,301664470,418151870,719816340,9.43,21,30
2021,3,09,12,2,36,대구광역시,18778,30609,49387,192849940,298863990,491713930,11.43,20.57,32
2021,3,09,19,3,37,대구광역시,35686,22416,58102,347930000,212237340,560167340,12.14,19,31
2021,3,09,26,4,38,대구광역시,53801,22095,75896,538664080,217019320,755683400,10.43,19.43,30
2021,4,10,03,5,39,대구광역시,17298,36835,54133,161911710,339147230,501058940,11.57,18.86,30
2021,4,10,10,1,40,대구광역시,14333,26410,40743,137978280,257895590,395873870,11.71,18.57,30
2021,4,10,17,2,41,대구광역시,9388,66630,76018,89022380,653267790,742290170,14.43,16.86,31
2021,4,10,24,3,42,대구광역시,3698,44200,47898,33982810,435191800,469174610,14,15.43,29
2021,4,10,31,4,43,대구광역시,2819,37334,40153,24698640,350389490,375088130,13.14,16.29,29
2021,4,11,07,1,44,대구광역시,1334,93962,95296,10881700,953513650,964395350,9.57,18.57,28
2021,4,11,14,2,45,대구광역시,12907,58130,71037,131195970,576971680,708167650,10.43,16.86,27
2021,4,11,21,3,46,대구광역시,24165,35247,59412,241515960,348507890,590023850,11.14,21.43,33
2021,4,11,28,4,47,대구광역시,40883,26066,66949,391153970,242605620,633759590,13.14,19.29,32
2021,4,12,05,1,48,대구광역시,29091,21074,50165,286150750,199591310,485742060,17.29,19,36
2021,4,12,12,2,49,대구광역시,18240,15409,33649,184549280,143570710,328119990,18.14,22.57,41
2021,4,12,19,3,50,대구광역시,5785,138325,144110,53825650,1339286300,1393111950,10.43,21,31
2021,4,12,26,4,51,대구광역시,1831,123141,124972,18225320,1196522660,1214747980,6.57,18.14,25
2022,1,01,02,5,52,대구광역시,10067,76683,86750,92176480,715309010,807485490,8.29,16,24
2021,1,01,10,1,1,대전광역시,815,4433,5248,7033650,39183240,46216890,6.86,20.57,27
2021,1,01,17,2,2,대전광역시,498,4636,5134,4603890,40370840,44974730,6.86,26.14,33
2021,1,01,24,3,3,대전광역시,354,20230,20584,2701680,183870040,186571720,7.14,24.14,31
2021,1,01,31,4,4,대전광역시,2348,26969,29317,19701390,234413430,254114820,6.86,17.43,24
2021,1,02,07,1,5,대전광역시,1423,24945,26368,11890320,233734730,245625050,6.29,17.14,23
2021,1,02,14,2,6,대전광역시,8163,27119,35282,78110100,255482690,333592790,7.57,20.29,28
2021,1,02,21,3,7,대전광역시,10527,14393,24920,95678760,134232200,229910960,10.57,25.14,36
2021,1,02,28,4,8,대전광역시,8672,19499,28171,76621900,171320090,247941990,11,29.57,41
2021,1,03,07,1,9,대전광역시,4506,26797,31303,42050170,252687700,294737870,9.43,21.86,31
2021,1,03,14,2,10,대전광역시,1274,21436,22710,12085960,200623150,212709110,5.71,22.29,28
2021,1,03,21,3,11,대전광역시,1118,20278,21396,13545520,191486500,205032020,5.29,27.29,33
2021,1,03,28,4,12,대전광역시,4096,22869,26965,38511840,214675740,253187580,11.86,23.43,35
2021,2,04,04,1,13,대전광역시,7103,15445,22548,62167280,140753110,202920390,13.71,20.71,34
2021,2,04,11,2,14,대전광역시,3661,10152,13813,34193930,99285760,133479690,11.86,18.86,31
2021,2,04,18,3,15,대전광역시,9811,9443,19254,94528360,90618210,185146570,9.57,19.29,29
2021,2,04,25,4,16,대전광역시,10717,8500,19217,100930320,79059170,179989490,7.86,21,29
2021,2,05,02,5,17,대전광역시,14266,14767,29033,126289430,129488240,255777670,8.43,22.29,31
2021,2,05,09,1,18,대전광역시,10078,19088,29166,98850490,174980660,273831150,11.14,19.14,30
2021,2,05,16,2,19,대전광역시,4954,11265,16219,48120650,107042190,155162840,12.29,18.86,31
2021,2,05,23,3,20,대전광역시,2800,49698,52498,26572840,483634740,510207580,11.57,18,30
2021,2,05,30,4,21,대전광역시,3924,37502,41426,34812300,345129270,379941570,7.86,18.86,27
2021,2,06,06,1,22,대전광역시,1604,40586,42190,14735880,397624620,412360500,8.43,18.57,27
2021,2,06,13,2,23,대전광역시,557,34189,34746,5119870,334660900,339780770,7.43,17,24
2021,2,06,20,3,24,대전광역시,3108,39004,42112,27153270,379753920,406907190,7,15.71,23
2021,2,06,27,4,25,대전광역시,15024,29951,44975,146021530,291433430,437454960,7.71,15.86,24
2021,3,07,04,1,26,대전광역시,20021,26706,46727,189764600,249321260,439085860,9.43,16.29,26
2021,3,07,11,2,27,대전광역시,9155,61817,70972,93393820,629804990,723198810,7.86,15.43,23
2021,3,07,18,3,28,대전광역시,22018,40310,62328,231203480,410665810,641869290,5.71,14.71,20
2021,3,07,25,4,29,대전광역시,8327,34886,43213,88027550,339546070,427573620,7.86,19.29,27
2021,3,08,01,5,30,대전광역시,30250,19988,50238,288203800,182595260,470799060,7.29,15.14,22
2021,3,08,08,1,31,대전광역시,29907,21853,51760,299832720,212795980,512628700,7.29,15.71,23
2021,3,08,15,2,32,대전광역시,53013,12380,65393,521147140,119890680,641037820,6,13,19
2021,3,08,22,3,33,대전광역시,66531,9707,76238,659691120,91805710,751496830,7.14,11.43,19
2021,3,08,29,4,34,대전광역시,41033,5718,46751,393458770,53101530,446560300,7.57,15.43,23
2021,3,09,05,1,35,대전광역시,22548,32973,55521,218157390,333785110,551942500,7.57,19.14,27
2021,3,09,12,2,36,대전광역시,13908,23469,37377,139082860,236247880,375330740,10.57,21.57,32
2021,3,09,19,3,37,대전광역시,24004,17580,41584,234025850,172121620,406147470,10,16.14,26
2021,3,09,26,4,38,대전광역시,36748,17811,54559,370582470,178030810,548613280,8.57,16.14,25
2021,4,10,03,5,39,대전광역시,11702,26267,37969,109770540,250341790,360112330,9.43,14.71,24
2021,4,10,10,1,40,대전광역시,9446,19597,29043,91820070,195848180,287668250,11,15.29,26
2021,4,10,17,2,41,대전광역시,6030,50296,56326,58415930,503542920,561958850,11.86,17,29
2021,4,10,24,3,42,대전광역시,2455,37003,39458,21810210,380559500,402369710,13.86,13,27
2021,4,10,31,4,43,대전광역시,1707,31834,33541,13482470,309728730,323211200,11.71,17.86,30
2021,4,11,07,1,44,대전광역시,414,72667,73081,3863500,780263190,784126690,6.71,17.86,25
2021,4,11,14,2,45,대전광역시,7703,44187,51890,81044130,464362490,545406620,8.43,16.29,25
2021,4,11,21,3,46,대전광역시,16255,28291,44546,170471350,305998470,476469820,10.14,17.57,28
2021,4,11,28,4,47,대전광역시,28926,21912,50838,285750550,215754970,501505520,11.14,17,28
2021,4,12,05,1,48,대전광역시,19616,15423,35039,202065850,155723090,357788940,15.43,16.86,32
2021,4,12,12,2,49,대전광역시,11767,10301,22068,124539080,106019440,230558520,16.14,20.43,37
2021,4,12,19,3,50,대전광역시,3788,106163,109951,38780380,1086332390,1125112770,10,18.57,29
2021,4,12,26,4,51,대전광역시,1293,94785,96078,13007310,971808320,984815630,6.29,14.43,21
2022,1,01,02,5,52,대전광역시,7438,56820,64258,69801070,557972710,627773780,6,14,20
2021,1,01,10,1,1,부산광역시,1532,9711,11243,12668780,80877630,93546410,8.71,31.57,40
2021,1,01,17,2,2,부산광역시,929,10031,10960,7682200,81923640,89605840,9.57,34.57,44
2021,1,01,24,3,3,부산광역시,638,31730,32368,4608270,276799320,281407590,9.14,32.86,42
2021,1,01,31,4,4,부산광역시,5048,48952,54000,41097480,415414740,456512220,8.29,33.29,42
2021,1,02,07,1,5,부산광역시,3114,49707,52821,25380510,451573550,476954060,8.57,34,43
2021,1,02,14,2,6,부산광역시,15167,55113,70280,139554850,509088780,648643630,10.57,32.29,43
2021,1,02,21,3,7,부산광역시,20668,29433,50101,185411190,272034150,457445340,11.71,34,46
2021,1,02,28,4,8,부산광역시,16822,40284,57106,145393390,350530970,495924360,13.57,41,55
2021,1,03,07,1,9,부산광역시,8899,56122,65021,84134290,507844930,591979220,13.71,33.86,48
2021,1,03,14,2,10,부산광역시,2272,46981,49253,21679290,422921110,444600400,9.14,31.86,41
2021,1,03,21,3,11,부산광역시,2572,44583,47155,27017250,402825670,429842920,7.43,37.43,45
2021,1,03,28,4,12,부산광역시,8193,47875,56068,72141120,435988270,508129390,13.86,35,49
2021,2,04,04,1,13,부산광역시,16734,33456,50190,138695750,295631190,434326940,20.29,32.71,53
2021,2,04,11,2,14,부산광역시,9510,26097,35607,80606050,238452050,319058100,18.14,32.57,51
2021,2,04,18,3,15,부산광역시,20538,21578,42116,189109080,195669490,384778570,16.29,29.71,46
2021,2,04,25,4,16,부산광역시,23996,18356,42352,213528970,168433760,381962730,12.29,27.86,40
2021,2,05,02,5,17,부산광역시,28279,34060,62339,244808540,286426580,531235120,15.14,30.43,46
2021,2,05,09,1,18,부산광역시,18650,38933,57583,178600950,342648770,521249720,15.14,30.57,46
2021,2,05,16,2,19,부산광역시,10735,26439,37174,99428960,238958410,338387370,17.71,35,53
2021,2,05,23,3,20,부산광역시,5075,103360,108435,44506360,976771400,1021277760,16.43,34,50
2021,2,05,30,4,21,부산광역시,8215,76733,84948,69215120,683090140,752305260,13.29,34,47
2021,2,06,06,1,22,부산광역시,4441,79539,83980,37903170,747326340,785229510,11,29.43,40
2021,2,06,13,2,23,부산광역시,1511,68743,70254,12937200,658057780,670994980,10,27,37
2021,2,06,20,3,24,부산광역시,5732,74222,79954,48855410,710721790,759577200,9,26.43,35
2021,2,06,27,4,25,부산광역시,34275,61698,95973,330548150,590402720,920950870,11.71,25.86,38
2021,3,07,04,1,26,부산광역시,48650,55278,103928,457621600,505125800,962747400,11.57,27.14,39
2021,3,07,11,2,27,부산광역시,21213,115332,136545,209108890,1154333200,1363442090,9.43,22.29,32
2021,3,07,18,3,28,부산광역시,47307,86485,133792,483625280,866102400,1349727680,9.57,23.43,33
2021,3,07,25,4,29,부산광역시,18586,70225,88811,191514150,687734020,879248170,11,27.14,38
2021,3,08,01,5,30,부산광역시,77409,48433,125842,745291340,442222610,1187513950,10.43,19.71,30
2021,3,08,08,1,31,부산광역시,81342,53931,135273,817192760,515135710,1332328470,9.29,23.29,33
2021,3,08,15,2,32,부산광역시,95986,23953,119939,942553010,228866720,1171419730,10.14,24,34
2021,3,08,22,3,33,부산광역시,117352,18692,136044,1166591180,176260510,1342851690,8.86,19.71,29
2021,3,08,29,4,34,부산광역시,81979,11134,93113,798134500,98148410,896282910,12.57,23.86,36
2021,3,09,05,1,35,부산광역시,45852,58972,104824,436756220,578928790,1015685010,12.71,25.57,38
2021,3,09,12,2,36,부산광역시,31301,44859,76160,316382520,435830880,752213400,16.14,26.57,43
2021,3,09,19,3,37,부산광역시,54710,32886,87596,542216180,310006190,852222370,13.86,27.71,42
2021,3,09,26,4,38,부산광역시,83312,34153,117465,843571350,335519730,1179091080,11.43,24.57,36
2021,4,10,03,5,39,부산광역시,26720,52642,79362,253473620,494209330,747682950,10.86,21.29,32
2021,4,10,10,1,40,부산광역시,22145,38228,60373,214420810,373407180,587827990,11.14,19.14,30
2021,4,10,17,2,41,부산광역시,14605,95059,109664,136546260,942083330,1078629590,13,23.14,36
2021,4,10,24,3,42,부산광역시,8307,70959,79266,66232560,709330900,775563460,15.71,23.29,39
2021,4,10,31,4,43,부산광역시,7001,61719,68720,54544620,585582900,640127520,15.57,23.71,39
2021,4,11,07,1,44,부산광역시,2734,141762,144496,21034970,1458296250,1479331220,12.43,25.14,38
2021,4,11,14,2,45,부산광역시,18807,83370,102177,191637320,849474120,1041111440,12.14,24.86,37
2021,4,11,21,3,46,부산광역시,34744,52439,87183,350846130,513979970,864826100,13.71,26.57,40
2021,4,11,28,4,47,부산광역시,57968,36884,94852,561418940,347461800,908880740,16.14,26.71,43
2021,4,12,05,1,48,부산광역시,42190,30680,72870,417246960,301755570,719002530,20.14,29.14,49
2021,4,12,12,2,49,부산광역시,26542,24077,50619,266089240,225957180,492046420,19.71,29.86,50
2021,4,12,19,3,50,부산광역시,8830,182103,190933,86726100,1808424430,1895150530,14.29,26.29,41
2021,4,12,26,4,51,부산광역시,2110,177242,179352,20711990,1755366880,1776078870,8.57,29.14,38
2022,1,01,02,5,52,부산광역시,13595,117717,131312,124884020,1118202560,1243086580,10.57,24.71,35
2021,1,01,10,1,1,서울특별시,7273,43631,50904,61444750,391765040,453209790,20.43,48.14,69
2021,1,01,17,2,2,서울특별시,4348,50907,55255,38021050,444533270,482554320,21.71,61.14,83
2021,1,01,24,3,3,서울특별시,6607,166278,172885,55377700,1553767300,1609145000,22.71,68.71,91
2021,1,01,31,4,4,서울특별시,21980,241091,263071,180870550,2155524540,2336395090,20.29,63.57,84
2021,1,02,07,1,5,서울특별시,14095,206928,221023,118341980,1985887700,2104229680,16.86,58.86,76
2021,1,02,14,2,6,서울특별시,50681,222074,272755,450817420,2139212370,2590029790,16.43,60.57,77
2021,1,02,21,3,7,서울특별시,62818,142065,204883,564904860,1392418380,1957323240,22,61.71,84
2021,1,02,28,4,8,서울특별시,43557,180998,224555,374188160,1601775790,1975963950,25,68.43,93
2021,1,03,07,1,9,서울특별시,23070,255145,278215,231190690,2432711540,2663902230,25,63.86,89
2021,1,03,14,2,10,서울특별시,8006,212227,220233,81818730,2015115330,2096934060,23.29,63.57,87
2021,1,03,21,3,11,서울특별시,18605,199121,217726,184545230,1891542000,2076087230,21.57,68.71,90
2021,1,03,28,4,12,서울특별시,52904,192591,245495,490058500,1887524800,2377583300,28.57,67,96
2021,2,04,04,1,13,서울특별시,89044,141023,230067,746756460,1315295640,2062052100,33.57,62.43,96
2021,2,04,11,2,14,서울특별시,52342,108356,160698,447445760,1050959960,1498405720,33.57,60.29,94
2021,2,04,18,3,15,서울특별시,89027,95721,184748,819016470,914984330,1734000800,30.57,59.14,90
2021,2,04,25,4,16,서울특별시,85800,86454,172254,769877360,806409570,1576286930,31.29,51.14,82
2021,2,05,02,5,17,서울특별시,104012,140496,244508,915932540,1249557140,2165489680,32.14,60.29,92
2021,2,05,09,1,18,서울특별시,71338,163652,234990,675799420,1507024510,2182823930,27.57,58.57,86
2021,2,05,16,2,19,서울특별시,41090,108234,149324,380820540,1014383870,1395204410,30,61.29,91
2021,2,05,23,3,20,서울특별시,24783,338884,363667,215943970,3334562020,3550505990,24.57,63.86,88
2021,2,05,30,4,21,서울특별시,61447,293227,354674,506093000,2764436200,3270529200,26.86,63.14,90
2021,2,06,06,1,22,서울특별시,23537,312727,336264,200751470,3081254640,3282006110,20.14,52.57,73
2021,2,06,13,2,23,서울특별시,10409,278174,288583,83018260,2731921470,2814939730,22.14,50.86,73
2021,2,06,20,3,24,서울특별시,25803,331764,357567,215862500,3246382170,3462244670,20.86,52.57,73
2021,2,06,27,4,25,서울특별시,91864,281736,373600,860517100,2790375270,3650892370,19.29,48,67
2021,3,07,04,1,26,서울특별시,98182,239291,337473,915476040,2279424210,3194900250,24.71,50.29,75
2021,3,07,11,2,27,서울특별시,53059,423875,476934,526143690,4417488710,4943632400,24.43,51.29,76
2021,3,07,18,3,28,서울특별시,144906,258502,403408,1448095200,2657468710,4105563910,19.29,50.86,70
2021,3,07,25,4,29,서울특별시,74185,250079,324264,747311920,2474367810,3221679730,20.29,54.86,75
2021,3,08,01,5,30,서울특별시,224439,195323,419762,2135001580,1831726510,3966728090,20.14,50.29,70
2021,3,08,08,1,31,서울특별시,226182,201930,428112,2228474870,2009693110,4238167980,19,46.71,66
2021,3,08,15,2,32,서울특별시,316553,136802,453355,3074872650,1352044280,4426916930,22.43,49.43,72
2021,3,08,22,3,33,서울특별시,399560,118609,518169,3848837590,1136243700,4985081290,24.57,48.86,73
2021,3,08,29,4,34,서울특별시,265042,80408,345450,2458800330,724815900,3183616230,22.29,57.57,80
2021,3,09,05,1,35,서울특별시,144148,267589,411737,1325152468,2709044960,4034197428,20,57.57,78
2021,3,09,12,2,36,서울특별시,97066,205509,302575,896946735,2052631990,2949578725,20.43,56.43,77
2021,3,09,19,3,37,서울특별시,172308,139353,311661,1463059340,1364481830,2827541170,20,62.29,82
2021,3,09,26,4,38,서울특별시,223296,146695,369991,2174539780,1449955830,3624495610,17.71,62.29,80
2021,4,10,03,5,39,서울특별시,80937,207763,288700,697737870,2009678640,2707416510,22.71,52.86,76
2021,4,10,10,1,40,서울특별시,78251,172325,250576,710149230,1746018750,2456167980,21.71,48.43,70
2021,4,10,17,2,41,서울특별시,54753,339254,394007,476714360,3470025580,3946739940,22.43,45.57,68
2021,4,10,24,3,42,서울특별시,36745,309429,346174,284734850,3209178920,3493913770,28,43.57,72
2021,4,10,31,4,43,서울특별시,37219,285866,323085,254630970,2867211320,3121842290,30.57,44.29,75
2021,4,11,07,1,44,서울특별시,19790,557088,576878,147471450,6068060020,6215531470,24.57,39.57,64
2021,4,11,14,2,45,서울특별시,65926,364022,429948,585774840,3934184700,4519959540,28.29,49.43,78
2021,4,11,21,3,46,서울특별시,126685,254971,381656,1226479190,2667236150,3893715340,32,56.43,88
2021,4,11,28,4,47,서울특별시,211505,189028,400533,2039707360,1895773560,3935480920,36.43,49.29,86
2021,4,12,05,1,48,서울특별시,160985,172302,333287,1617784760,1825668070,3443452830,39.71,49.71,89
2021,4,12,12,2,49,서울특별시,104352,131203,235555,1052180190,1293761800,2345941990,34.86,51.43,86
2021,4,12,19,3,50,서울특별시,36397,753517,789914,371837670,7849968250,8221805920,22.14,52,74
2021,4,12,26,4,51,서울특별시,16437,753716,770153,148127390,7752912870,7901040260,15.57,50.14,66
2022,1,01,02,5,52,서울특별시,64883,531993,596876,598927990,5245694130,5844622120,18.57,46.57,65
2021,1,01,10,1,1,세종특별자치시,166,776,942,1290880,6532140,7823020,3.43,10.71,14
2021,1,01,17,2,2,세종특별자치시,88,878,966,756180,7418980,8175160,2.14,13.29,15
2021,1,01,24,3,3,세종특별자치시,27,3976,4003,181000,34832170,35013170,0.71,11.14,12
2021,1,01,31,4,4,세종특별자치시,305,5983,6288,2490270,49493420,51983690,2.43,8.86,11
2021,1,02,07,1,5,세종특별자치시,278,3907,4185,2316970,35554910,37871880,4,10.29,14
2021,1,02,14,2,6,세종특별자치시,904,4627,5531,8272400,42682740,50955140,5.43,11.29,17
2021,1,02,21,3,7,세종특별자치시,1232,2126,3358,10704510,19094850,29799360,5.71,11.57,17
2021,1,02,28,4,8,세종특별자치시,924,3387,4311,7744820,28586940,36331760,4.57,12,17
2021,1,03,07,1,9,세종특별자치시,361,4846,5207,3203360,44860300,48063660,2.43,9.43,12
2021,1,03,14,2,10,세종특별자치시,79,3512,3591,738870,32486530,33225400,1.57,12.43,14
2021,1,03,21,3,11,세종특별자치시,56,3625,3681,468970,33000510,33469480,1.71,15.43,17
2021,1,03,28,4,12,세종특별자치시,983,4070,5053,8068250,36329050,44397300,3.57,13.14,17
2021,2,04,04,1,13,세종특별자치시,1259,2242,3501,10742820,20175940,30918760,3.71,9.57,13
2021,2,04,11,2,14,세종특별자치시,623,1834,2457,5520500,17329410,22849910,3.29,11,14
2021,2,04,18,3,15,세종특별자치시,1413,1467,2880,13353140,14126470,27479610,3,9.57,13
2021,2,04,25,4,16,세종특별자치시,1476,1525,3001,13374420,13958750,27333170,4.57,10.71,15
2021,2,05,02,5,17,세종특별자치시,2239,2690,4929,19570160,24102810,43672970,5.71,9.29,15
2021,2,05,09,1,18,세종특별자치시,1705,4452,6157,15244190,39212460,54456650,5.14,9.71,15
2021,2,05,16,2,19,세종특별자치시,870,1898,2768,7483770,17198500,24682270,7.14,9.57,17
2021,2,05,23,3,20,세종특별자치시,695,7951,8646,5302240,74182240,79484480,5.29,7.71,13
2021,2,05,30,4,21,세종특별자치시,435,5366,5801,3606170,48610550,52216720,2.86,8.71,12
2021,2,06,06,1,22,세종특별자치시,186,6266,6452,1704840,60364070,62068910,1.57,9.57,11
2021,2,06,13,2,23,세종특별자치시,48,5179,5227,387000,49313630,49700630,1.43,8.57,10
2021,2,06,20,3,24,세종특별자치시,311,6333,6644,2713570,59561470,62275040,1.14,8.71,10
2021,2,06,27,4,25,세종특별자치시,1850,5007,6857,17907240,47764870,65672110,1.57,7.43,9
2021,3,07,04,1,26,세종특별자치시,3333,6114,9447,30032910,56113330,86146240,3,8.29,11
2021,3,07,11,2,27,세종특별자치시,1279,12741,14020,12944300,129909950,142854250,2.57,6.57,9
2021,3,07,18,3,28,세종특별자치시,3297,8159,11456,34248010,82438590,116686600,2,7.14,9
2021,3,07,25,4,29,세종특별자치시,1170,9404,10574,12229720,91473530,103703250,1.29,9,10
2021,3,08,01,5,30,세종특별자치시,6617,6532,13149,63449400,60604380,124053780,2.14,5,7
2021,3,08,08,1,31,세종특별자치시,6381,5427,11808,66173680,53023640,119197320,3.29,4.86,8
2021,3,08,15,2,32,세종특별자치시,12333,2797,15130,123257290,26808100,150065390,2.71,4.86,8
2021,3,08,22,3,33,세종특별자치시,13285,2254,15539,132337400,21743270,154080670,2.71,5.14,8
2021,3,08,29,4,34,세종특별자치시,7401,898,8299,72013170,8361180,80374350,3.71,5.14,9
2021,3,09,05,1,35,세종특별자치시,3782,6059,9841,36611770,59480860,96092630,4,5,9
2021,3,09,12,2,36,세종특별자치시,1856,3304,5160,18624310,33007040,51631350,3.71,5.14,9
2021,3,09,19,3,37,세종특별자치시,3591,3354,6945,35148500,32392610,67541110,4,5,9
2021,3,09,26,4,38,세종특별자치시,5623,3287,8910,55548440,32180300,87728740,4,6,10
2021,4,10,03,5,39,세종특별자치시,1553,4078,5631,14627650,38435470,53063120,4.43,4.14,9
2021,4,10,10,1,40,세종특별자치시,1263,3208,4471,12742300,31748880,44491180,5.14,5.43,11
2021,4,10,17,2,41,세종특별자치시,1035,8353,9388,9677630,81361810,91039440,4.14,6.29,10
2021,4,10,24,3,42,세종특별자치시,678,6423,7101,5702500,63506660,69209160,3.57,5.71,9
2021,4,10,31,4,43,세종특별자치시,151,5082,5233,1441500,47763470,49204970,2.29,7.29,10
2021,4,11,07,1,44,세종특별자치시,410,13017,13427,3729000,135315180,139044180,1,6.14,7
2021,4,11,14,2,45,세종특별자치시,778,8114,8892,8299990,83235270,91535260,0.71,7,8
2021,4,11,21,3,46,세종특별자치시,2104,5099,7203,22005590,50888090,72893680,1.71,9.43,11
2021,4,11,28,4,47,세종특별자치시,3916,4145,8061,38701910,38776960,77478870,3.71,6.57,10
2021,4,12,05,1,48,세종특별자치시,2701,3198,5899,27337000,28258850,55595850,3.86,8.14,12
2021,4,12,12,2,49,세종특별자치시,1735,1818,3553,17546280,16936210,34482490,5.43,9,14
2021,4,12,19,3,50,세종특별자치시,500,19498,19998,4273740,192326910,196600650,3,4.86,8
2021,4,12,26,4,51,세종특별자치시,111,16591,16702,1133570,164057830,165191400,1,4.57,6
2022,1,01,02,5,52,세종특별자치시,1185,9237,10422,11153400,89290300,100443700,0.71,4.14,5
2021,1,01,10,1,1,울산광역시,416,2058,2474,3628830,18029680,21658510,5.14,15,20
2021,1,01,17,2,2,울산광역시,221,2560,2781,2018900,21827020,23845920,4.71,19.71,24
2021,1,01,24,3,3,울산광역시,204,9730,9934,1479580,85073010,86552590,3,21.71,25
2021,1,01,31,4,4,울산광역시,1511,14728,16239,11996300,127009350,139005650,4.43,17.86,22
2021,1,02,07,1,5,울산광역시,995,13766,14761,8083360,130160900,138244260,5,15,20
2021,1,02,14,2,6,울산광역시,4730,16983,21713,42817440,162069700,204887140,5,16,21
2021,1,02,21,3,7,울산광역시,6160,8503,14663,54456310,82340670,136796980,5.43,19.14,25
2021,1,02,28,4,8,울산광역시,5565,11428,16993,48658100,102344910,151003010,7,22.57,30
2021,1,03,07,1,9,울산광역시,3002,16015,19017,27458130,147646360,175104490,5,17.86,23
2021,1,03,14,2,10,울산광역시,753,11644,12397,7336510,107823000,115159510,2,18.71,21
2021,1,03,21,3,11,울산광역시,573,11625,12198,6541510,107167950,113709460,3.57,22.29,26
2021,1,03,28,4,12,울산광역시,2535,13523,16058,22636400,127816190,150452590,8.57,20.86,29
2021,2,04,04,1,13,울산광역시,4368,9813,14181,37558740,90475590,128034330,9,16.71,26
2021,2,04,11,2,14,울산광역시,2255,7026,9281,19500230,68367910,87868140,6.57,17,24
2021,2,04,18,3,15,울산광역시,5434,5163,10597,50315770,49053440,99369210,4.86,15.43,20
2021,2,04,25,4,16,울산광역시,5410,4368,9778,49145070,41945660,91090730,5.43,16,21
2021,2,05,02,5,17,울산광역시,6524,5992,12516,56169990,52130950,108300940,7.43,16.86,24
2021,2,05,09,1,18,울산광역시,4212,7806,12018,39898200,69851380,109749580,9.29,14.57,24
2021,2,05,16,2,19,울산광역시,2494,5437,7931,22785230,50908340,73693570,9.71,15.86,26
2021,2,05,23,3,20,울산광역시,1012,29285,30297,8894060,286600740,295494800,8.57,16.43,25
2021,2,05,30,4,21,울산광역시,2347,20123,22470,20488820,187619950,208108770,6.43,14.71,21
2021,2,06,06,1,22,울산광역시,1279,21442,22721,11833210,205876810,217710020,5.29,13.71,19
2021,2,06,13,2,23,울산광역시,582,18513,19095,5223600,177846880,183070480,4.29,14.14,18
2021,2,06,20,3,24,울산광역시,1310,20389,21699,11332470,197820040,209152510,3.14,14.57,18
2021,2,06,27,4,25,울산광역시,8917,16111,25028,84485420,156955340,241440760,4.43,13.71,18
2021,3,07,04,1,26,울산광역시,11341,12767,24108,104188990,119613160,223802150,4.43,16.71,21
2021,3,07,11,2,27,울산광역시,6897,35156,42053,66463560,356180640,422644200,4.86,11.57,16
2021,3,07,18,3,28,울산광역시,13192,24053,37245,134612980,241671320,376284300,5.29,10,15
2021,3,07,25,4,29,울산광역시,5447,23298,28745,55368270,221807620,277175890,6.86,13.14,20
2021,3,08,01,5,30,울산광역시,23811,16606,40417,222698520,148818850,371517370,4.43,8.86,13
2021,3,08,08,1,31,울산광역시,29554,20411,49965,282611340,194551370,477162710,3.43,8,11
2021,3,08,15,2,32,울산광역시,41112,7682,48794,394970590,76918070,471888660,3.57,8.57,12
2021,3,08,22,3,33,울산광역시,41981,5445,47426,405218680,51458690,456677370,4.29,8,12
2021,3,08,29,4,34,울산광역시,28081,2852,30933,269899320,26728550,296627870,5.29,9,14
2021,3,09,05,1,35,울산광역시,13960,17038,30998,130398890,174233810,304632700,5,12.43,17
2021,3,09,12,2,36,울산광역시,8083,11777,19860,76215770,115491560,191707330,7.14,13.14,20
2021,3,09,19,3,37,울산광역시,16165,9274,25439,152562070,86999170,239561240,5.29,11.57,17
2021,3,09,26,4,38,울산광역시,24236,10041,34277,234356980,96983240,331340220,4.57,12.14,17
2021,4,10,03,5,39,울산광역시,7589,14471,22060,67923680,136896430,204820110,6.14,10.71,17
2021,4,10,10,1,40,울산광역시,6263,10793,17056,59323340,104690280,164013620,7,11.29,18
2021,4,10,17,2,41,울산광역시,4907,28596,33503,45235120,283311470,328546590,10.86,10.71,22
2021,4,10,24,3,42,울산광역시,1982,21804,23786,17663310,222548070,240211380,10.14,10.29,20
2021,4,10,31,4,43,울산광역시,1147,18121,19268,9688050,179663700,189351750,8.43,10.71,19
2021,4,11,07,1,44,울산광역시,466,42248,42714,4586000,437736140,442322140,4.43,7.71,12
2021,4,11,14,2,45,울산광역시,5526,24846,30372,55311770,252685330,307997100,3.29,8.71,12
2021,4,11,21,3,46,울산광역시,10134,14483,24617,101081400,141964640,243046040,5.57,12.86,18
2021,4,11,28,4,47,울산광역시,18246,12812,31058,168551230,115493530,284044760,7.29,12.86,20
2021,4,12,05,1,48,울산광역시,12191,10187,22378,118595550,102831400,221426950,7.86,13.29,21
2021,4,12,12,2,49,울산광역시,6950,6521,13471,67628860,64856850,132485710,8.57,16.14,25
2021,4,12,19,3,50,울산광역시,2539,51787,54326,23125790,528376340,551502130,5.57,10.29,16
2021,4,12,26,4,51,울산광역시,681,55133,55814,6026410,551657310,557683720,2.86,9.43,12
2022,1,01,02,5,52,울산광역시,4543,34296,38839,40856730,341024580,381881310,3.71,9.14,13
2021,1,01,10,1,1,인천광역시,1031,5207,6238,8937400,45544610,54482010,9.86,25.86,36
2021,1,01,17,2,2,인천광역시,627,5037,5664,5715510,44203650,49919160,8,28.14,36
2021,1,01,24,3,3,인천광역시,396,22701,23097,3053350,209036260,212089610,8.14,29,37
2021,1,01,31,4,4,인천광역시,2730,38043,40773,23218510,336758840,359977350,9.14,25,34
2021,1,02,07,1,5,인천광역시,2132,33159,35291,17196080,314730410,331926490,9.29,23.29,33
2021,1,02,14,2,6,인천광역시,8930,36720,45650,84296710,354008690,438305400,10.71,25.57,36
2021,1,02,21,3,7,인천광역시,12265,20410,32675,115097110,197065840,312162950,12.43,29.57,42
2021,1,02,28,4,8,인천광역시,10514,26986,37500,93934410,247481800,341416210,13,36.14,49
2021,1,03,07,1,9,인천광역시,5610,36733,42343,55611990,351832820,407444810,11.43,31.57,43
2021,1,03,14,2,10,인천광역시,1369,29861,31230,13719170,284093380,297812550,6.86,31.14,38
2021,1,03,21,3,11,인천광역시,1635,28014,29649,17639270,264311090,281950360,7.57,31.43,39
2021,1,03,28,4,12,인천광역시,5767,34532,40299,53084180,326481660,379565840,13.29,31.57,45
2021,2,04,04,1,13,인천광역시,9119,23341,32460,80216410,214686600,294903010,16.57,28.14,45
2021,2,04,11,2,14,인천광역시,4821,16334,21155,44741220,159174140,203915360,14.29,25.43,40
2021,2,04,18,3,15,인천광역시,13618,14740,28358,131188280,141752720,272941000,12.71,24,37
2021,2,04,25,4,16,인천광역시,15005,14325,29330,141260980,136756070,278017050,12.14,23.14,35
2021,2,05,02,5,17,인천광역시,18112,20183,38295,162274130,181098980,343373110,12.71,27.43,40
2021,2,05,09,1,18,인천광역시,14269,27879,42148,138043680,262012830,400056510,14.29,26.86,41
2021,2,05,16,2,19,인천광역시,6324,15893,22217,62407010,152269920,214676930,14.86,27.71,43
2021,2,05,23,3,20,인천광역시,3069,68650,71719,28484300,680075700,708560000,13.57,28.86,42
2021,2,05,30,4,21,인천광역시,6267,51563,57830,59003590,483413260,542416850,11.86,30.43,42
2021,2,06,06,1,22,인천광역시,3215,56782,59997,26676920,561903140,588580060,10.71,26.14,37
2021,2,06,13,2,23,인천광역시,1216,48557,49773,9748530,478867080,488615610,8.29,26.57,35
2021,2,06,20,3,24,인천광역시,4065,53841,57906,36834430,530111910,566946340,8.14,26.14,34
2021,2,06,27,4,25,인천광역시,21615,43870,65485,213874610,432118690,645993300,9.71,25.57,35
2021,3,07,04,1,26,인천광역시,25098,35352,60450,243641960,336934180,580576140,11.29,25.14,36
2021,3,07,11,2,27,인천광역시,12748,81872,94620,127926860,842470850,970397710,10,19.86,30
2021,3,07,18,3,28,인천광역시,26027,45106,71133,271792530,465159350,736951880,6.86,15.29,22
2021,3,07,25,4,29,인천광역시,11648,48421,60069,120808620,481251440,602060060,8.57,18.29,27
2021,3,08,01,5,30,인천광역시,44811,35540,80351,429232740,333412670,762645410,7.71,14.57,22
2021,3,08,08,1,31,인천광역시,48672,38676,87348,488076810,382390950,870467760,7.14,16,23
2021,3,08,15,2,32,인천광역시,77131,20030,97161,766144280,200737590,966881870,7.57,14.43,22
2021,3,08,22,3,33,인천광역시,94955,14439,109394,958723760,141062270,1099786030,8.43,13.29,22
2021,3,08,29,4,34,인천광역시,61014,7340,68354,600059960,67854100,667914060,10.71,21.57,32
2021,3,09,05,1,35,인천광역시,31235,44385,75620,309493730,446487850,755981580,9.86,22,32
2021,3,09,12,2,36,인천광역시,18624,30741,49365,187407370,309366790,496774160,12.57,23.71,36
2021,3,09,19,3,37,인천광역시,31736,23844,55580,320344820,233533070,553877890,12.71,23.29,36
2021,3,09,26,4,38,인천광역시,49153,25662,74815,502370850,260415130,762785980,10.43,19.71,30
2021,4,10,03,5,39,인천광역시,15420,32671,48091,144545760,314051670,458597430,11.14,21,32
2021,4,10,10,1,40,인천광역시,13733,26314,40047,133970480,263345560,397316040,12,21,33
2021,4,10,17,2,41,인천광역시,7475,67466,74941,71899610,687331720,759231330,13.29,21.57,35
2021,4,10,24,3,42,인천광역시,4336,53028,57364,39707590,548104860,587812450,14.29,20.57,35
2021,4,10,31,4,43,인천광역시,2469,42904,45373,20895300,421878180,442773480,13.29,18.86,32
2021,4,11,07,1,44,인천광역시,836,108702,109538,6177500,1149969950,1156147450,12.29,19.57,32
2021,4,11,14,2,45,인천광역시,11040,65964,77004,114437440,687271270,801708710,11.43,19.71,31
2021,4,11,21,3,46,인천광역시,28298,36951,65249,285278080,377001980,662280060,13.71,25.14,39
2021,4,11,28,4,47,인천광역시,40828,26950,67778,407644460,261691690,669336150,15.29,20.86,36
2021,4,12,05,1,48,인천광역시,26699,21145,47844,267555890,211882670,479438560,17.57,23.71,41
2021,4,12,12,2,49,인천광역시,14871,13809,28680,156229180,144203300,300432480,17.71,24.29,42
2021,4,12,19,3,50,인천광역시,5242,144141,149383,52087410,1478930360,1531017770,12.71,21.43,34
2021,4,12,26,4,51,인천광역시,2365,136560,138925,21256110,1395946140,1417202250,10.86,19.86,31
2022,1,01,02,5,52,인천광역시,10073,87128,97201,95317990,867906770,963224760,7.86,16.43,24
2021,1,01,10,1,1,전라남도,546,1767,2313,4681260,15341150,20022410,4.71,8.86,14
2021,1,01,17,2,2,전라남도,428,1781,2209,3582840,15528210,19111050,4.71,10,15
2021,1,01,24,3,3,전라남도,168,6771,6939,1338910,57797500,59136410,4.14,9,13
2021,1,01,31,4,4,전라남도,1108,13351,14459,9492410,105585040,115077450,3.71,8.57,12
2021,1,02,07,1,5,전라남도,684,10984,11668,5785920,97466570,103252490,3.86,8.71,13
2021,1,02,14,2,6,전라남도,4355,12615,16970,41605530,116664550,158270080,4.86,10.57,15
2021,1,02,21,3,7,전라남도,6002,6079,12081,54036660,54445740,108482400,6.29,12.14,18
2021,1,02,28,4,8,전라남도,5078,8117,13195,44294190,69360900,113655090,8.71,9.71,18
2021,1,03,07,1,9,전라남도,2782,11891,14673,25755270,107843010,133598280,5.29,10.57,16
2021,1,03,14,2,10,전라남도,1295,9769,11064,11155520,86528030,97683550,3.29,12.57,16
2021,1,03,21,3,11,전라남도,850,9859,10709,9460890,87675290,97136180,4.57,15.43,20
2021,1,03,28,4,12,전라남도,4327,13583,17910,36144000,118192690,154336690,7.86,13.14,21
2021,2,04,04,1,13,전라남도,5464,10201,15665,48666220,91248340,139914560,6.29,10.29,17
2021,2,04,11,2,14,전라남도,2976,6071,9047,28452850,58022990,86475840,4.86,11.14,16
2021,2,04,18,3,15,전라남도,6989,5443,12432,66125530,49816230,115941760,4.71,11.29,16
2021,2,04,25,4,16,전라남도,6520,4580,11100,61905270,40804220,102709490,5.57,11,17
2021,2,05,02,5,17,전라남도,7917,5728,13645,68885450,50698200,119583650,5.86,10.29,16
2021,2,05,09,1,18,전라남도,6120,10412,16532,54385870,91167160,145553030,7.57,9.86,17
2021,2,05,16,2,19,전라남도,2737,4431,7168,25813930,40853740,66667670,9,12.29,21
2021,2,05,23,3,20,전라남도,1393,23909,25302,12907660,229512000,242419660,6.71,11.71,18
2021,2,05,30,4,21,전라남도,2248,17547,19795,20009780,162660300,182670080,5.43,11,16
2021,2,06,06,1,22,전라남도,1318,21153,22471,12400820,200378260,212779080,5.14,11.43,17
2021,2,06,13,2,23,전라남도,443,18990,19433,4402700,176082200,180484900,4.57,10.43,15
2021,2,06,20,3,24,전라남도,1756,18717,20473,14960730,177466560,192427290,3.71,10.14,14
2021,2,06,27,4,25,전라남도,8970,15029,23999,85494270,145095400,230589670,3.29,9.57,13
2021,3,07,04,1,26,전라남도,12496,12937,25433,112777360,115002360,227779720,4.71,11,16
2021,3,07,11,2,27,전라남도,7585,34323,41908,68653880,323386590,392040470,6.29,8.71,15
2021,3,07,18,3,28,전라남도,13478,21266,34744,128326490,199847710,328174200,6.71,9.71,16
2021,3,07,25,4,29,전라남도,5907,22492,28399,55105760,200684270,255790030,5.29,11.57,17
2021,3,08,01,5,30,전라남도,22176,15082,37258,207158890,127100510,334259400,5.14,7.14,12
2021,3,08,08,1,31,전라남도,23147,15434,38581,228229130,138171950,366401080,5.14,7.57,13
2021,3,08,15,2,32,전라남도,42868,7807,50675,408429370,70263980,478693350,5.43,8.29,14
2021,3,08,22,3,33,전라남도,49218,4993,54211,455534060,43580310,499114370,5,8.71,14
2021,3,08,29,4,34,전라남도,32353,2517,34870,286376020,21032320,307408340,6.71,8.71,15
2021,3,09,05,1,35,전라남도,15772,16432,32204,140733140,152637420,293370560,5.71,9.14,15
2021,3,09,12,2,36,전라남도,9210,10248,19458,83011230,94848620,177859850,7.14,9.71,17
2021,3,09,19,3,37,전라남도,16223,9081,25304,147779190,80822560,228601750,6,7.14,13
2021,3,09,26,4,38,전라남도,26699,10858,37557,245237910,98015230,343253140,5.86,8,14
2021,4,10,03,5,39,전라남도,7289,13004,20293,66172080,115525180,181697260,6,6.71,13
2021,4,10,10,1,40,전라남도,7113,10985,18098,65102250,99209520,164311770,7.43,8,15
2021,4,10,17,2,41,전라남도,5289,30295,35584,45714470,270902210,316616680,9.43,9.57,19
2021,4,10,24,3,42,전라남도,4501,19858,24359,35618600,176877260,212495860,8.14,9.43,18
2021,4,10,31,4,43,전라남도,4404,16641,21045,34690000,145213030,179903030,7,9.57,17
2021,4,11,07,1,44,전라남도,4086,40105,44191,30251000,404823690,435074690,3.14,7.57,11
2021,4,11,14,2,45,전라남도,6498,26543,33041,65663380,255948940,321612320,3,7.71,11
2021,4,11,21,3,46,전라남도,13393,13310,26703,129357590,126002660,255360250,4.29,11.14,15
2021,4,11,28,4,47,전라남도,18775,9862,28637,179979030,87738210,267717240,6.71,10.43,17
2021,4,12,05,1,48,전라남도,13417,9373,22790,126983630,79066040,206049670,6.86,8.71,16
2021,4,12,12,2,49,전라남도,8554,7176,15730,76712210,59451500,136163710,7.29,12,19
2021,4,12,19,3,50,전라남도,4526,56707,61233,35765460,526820080,562585540,6.57,9.29,16
2021,4,12,26,4,51,전라남도,787,49567,50354,7219900,480406100,487626000,4.29,5.86,10
2022,1,01,02,5,52,전라남도,4510,29282,33792,39315120,272962140,312277260,2.86,6.57,9
2021,1,01,10,1,1,전라북도,2484,2579,5063,21744620,22878900,44623520,5.71,17.14,23
2021,1,01,17,2,2,전라북도,501,2666,3167,4409970,23113240,27523210,6.29,19.86,26
2021,1,01,24,3,3,전라북도,303,12675,12978,2372990,110288080,112661070,5.43,21.14,27
2021,1,01,31,4,4,전라북도,1648,20186,21834,13288980,170356490,183645470,5.14,18,23
2021,1,02,07,1,5,전라북도,1234,20111,21345,10199380,182483690,192683070,7.29,15.71,23
2021,1,02,14,2,6,전라북도,6253,21402,27655,56408910,192335110,248744020,6.29,18,24
2021,1,02,21,3,7,전라북도,9049,10964,20013,78586470,97798870,176385340,8.57,20.86,29
2021,1,02,28,4,8,전라북도,7413,13179,20592,61742920,111866980,173609900,11.14,21.57,33
2021,1,03,07,1,9,전라북도,3680,18057,21737,32904830,161504900,194409730,8.43,19.29,28
2021,1,03,14,2,10,전라북도,1222,15041,16263,10760840,133789030,144549870,5.29,20.29,26
2021,1,03,21,3,11,전라북도,971,14412,15383,9748600,130458740,140207340,6.86,22.43,29
2021,1,03,28,4,12,전라북도,2233,20050,22283,20137820,181375710,201513530,11.29,20.14,31
2021,2,04,04,1,13,전라북도,5426,12430,17856,45176390,109276630,154453020,10.71,18.29,29
2021,2,04,11,2,14,전라북도,3006,7845,10851,25022570,72752990,97775560,9,16.43,25
2021,2,04,18,3,15,전라북도,7162,6588,13750,64950110,58914820,123864930,7.71,16.14,24
2021,2,04,25,4,16,전라북도,8368,5788,14156,74094720,52106090,126200810,8.43,16.57,25
2021,2,05,02,5,17,전라북도,10405,8838,19243,87990140,75082490,163072630,10.14,15.14,25
2021,2,05,09,1,18,전라북도,7611,13335,20946,68584490,115019960,183604450,10.86,13.57,24
2021,2,05,16,2,19,전라북도,4405,7906,12311,40693420,71189450,111882870,12.29,17.43,30
2021,2,05,23,3,20,전라북도,2451,40442,42893,20660340,379194000,399854340,13.57,17.71,31
2021,2,05,30,4,21,전라북도,3474,28545,32019,28217060,256066730,284283790,9.71,16.86,27
2021,2,06,06,1,22,전라북도,1598,32675,34273,13920560,302075720,315996280,9,16.43,25
2021,2,06,13,2,23,전라북도,588,28368,28956,5020000,260846050,265866050,6.29,14.57,21
2021,2,06,20,3,24,전라북도,2713,30071,32784,24341700,279318590,303660290,5.57,15.43,21
2021,2,06,27,4,25,전라북도,12747,23834,36581,118024960,221378000,339402960,5.71,16.29,22
2021,3,07,04,1,26,전라북도,17931,19638,37569,159062690,176085310,335148000,8.43,17,25
2021,3,07,11,2,27,전라북도,9304,51867,61171,88012250,502819260,590831510,9.43,12.29,22
2021,3,07,18,3,28,전라북도,18383,35737,54120,185479260,344922120,530401380,7.71,11.43,19
2021,3,07,25,4,29,전라북도,7637,39145,46782,75531160,356340580,431871740,7.86,16,24
2021,3,08,01,5,30,전라북도,34154,27429,61583,314031180,236902190,550933370,6.71,15.43,22
2021,3,08,08,1,31,전라북도,34934,24325,59259,333861500,224492120,558353620,4.86,13.86,19
2021,3,08,15,2,32,전라북도,62854,12705,75559,589120570,118483970,707604540,5.57,13.43,19
2021,3,08,22,3,33,전라북도,73391,9856,83247,695684140,87570260,783254400,5.57,13,19
2021,3,08,29,4,34,전라북도,40287,4134,44421,370278620,35187330,405465950,6.71,13.29,20
2021,3,09,05,1,35,전라북도,18860,24875,43735,172345090,237814470,410159560,6,16,22
2021,3,09,12,2,36,전라북도,10678,16935,27613,99864910,160954400,260819310,8.71,17,26
2021,3,09,19,3,37,전라북도,21428,13140,34568,207034690,121165770,328200460,8.86,17.29,26
2021,3,09,26,4,38,전라북도,31469,13523,44992,298908920,125905990,424814910,8.86,14.86,24
2021,4,10,03,5,39,전라북도,10087,19738,29825,90286560,180812530,271099090,9.71,15,25
2021,4,10,10,1,40,전라북도,8356,14935,23291,77659270,141293830,218953100,10.71,15,26
2021,4,10,17,2,41,전라북도,5684,43371,49055,49126270,411231890,460358160,10.57,16.86,27
2021,4,10,24,3,42,전라북도,2814,28585,31399,21889400,278405300,300294700,10.86,17.57,28
2021,4,10,31,4,43,전라북도,1439,22852,24291,9968000,214566590,224534590,8,19.29,27
2021,4,11,07,1,44,전라북도,768,59934,60702,6960000,592743340,599703340,5.86,18.71,25
2021,4,11,14,2,45,전라북도,6699,35029,41728,66093010,339279790,405372800,5,21.14,26
2021,4,11,21,3,46,전라북도,13808,19246,33054,134004130,183285610,317289740,7.14,22.86,30
2021,4,11,28,4,47,전라북도,23542,14633,38175,216453140,133011050,349464190,8.29,19.43,28
2021,4,12,05,1,48,전라북도,18530,14295,32825,176207320,131807860,308015180,12.14,19,31
2021,4,12,12,2,49,전라북도,11269,9034,20303,107451500,85990380,193441880,12.57,19.71,32
2021,4,12,19,3,50,전라북도,4203,86013,90216,36036940,832793580,868830520,9,19.57,29
2021,4,12,26,4,51,전라북도,1575,74739,76314,13253480,724939330,738192810,7.14,18.29,25
2022,1,01,02,5,52,전라북도,6814,46628,53442,60425170,438105810,498530980,4.86,21.57,26
2021,1,01,10,1,1,제주특별자치도,217,927,1144,1848650,8086250,9934900,3,10.86,14
2021,1,01,17,2,2,제주특별자치도,153,1023,1176,1283660,8760910,10044570,3.43,13.14,17
2021,1,01,24,3,3,제주특별자치도,87,5583,5670,769040,49460110,50229150,3,13,16
2021,1,01,31,4,4,제주특별자치도,697,8752,9449,6074550,73308040,79382590,3.14,10.86,14
2021,1,02,07,1,5,제주특별자치도,466,8168,8634,3971350,73146120,77117470,3.71,10,14
2021,1,02,14,2,6,제주특별자치도,1890,9011,10901,17448990,84049260,101498250,4.29,12.14,16
2021,1,02,21,3,7,제주특별자치도,3029,4696,7725,27764480,43061080,70825560,6,14.71,21
2021,1,02,28,4,8,제주특별자치도,2475,6300,8775,21896360,55036790,76933150,4.86,14.86,20
2021,1,03,07,1,9,제주특별자치도,1316,8721,10037,12177360,79575060,91752420,2.71,12.71,15
2021,1,03,14,2,10,제주특별자치도,385,6453,6838,3722810,58419750,62142560,1.71,15.57,17
2021,1,03,21,3,11,제주특별자치도,396,6445,6841,4361680,58139180,62500860,3.29,16.86,20
2021,1,03,28,4,12,제주특별자치도,554,7743,8297,6087070,70626990,76714060,6,13,19
2021,2,04,04,1,13,제주특별자치도,2529,6475,9004,22064030,58172730,80236760,4.71,11.86,17
2021,2,04,11,2,14,제주특별자치도,1523,4427,5950,13603800,41744570,55348370,3.57,13,17
2021,2,04,18,3,15,제주특별자치도,3403,3964,7367,32190120,36795360,68985480,2.86,11.29,14
2021,2,04,25,4,16,제주특별자치도,3656,3078,6734,33738170,28575730,62313900,5.29,10.71,16
2021,2,05,02,5,17,제주특별자치도,4311,4523,8834,37350370,40558030,77908400,5.57,12.14,18
2021,2,05,09,1,18,제주특별자치도,3082,7034,10116,28973780,63844380,92818160,7,11.43,18
2021,2,05,16,2,19,제주특별자치도,1392,2722,4114,13192500,25800410,38992910,7.14,11.57,19
2021,2,05,23,3,20,제주특별자치도,491,12843,13334,4621500,124043700,128665200,5.57,9.43,15
2021,2,05,30,4,21,제주특별자치도,772,8980,9752,7120000,81674200,88794200,2.43,10.29,13
2021,2,06,06,1,22,제주특별자치도,367,10861,11228,3581000,104946700,108527700,2,10,12
2021,2,06,13,2,23,제주특별자치도,306,9710,10016,3081500,93853900,96935400,2.29,9.43,12
2021,2,06,20,3,24,제주특별자치도,789,10124,10913,7658500,98517800,106176300,1.86,9.71,12
2021,2,06,27,4,25,제주특별자치도,4150,8739,12889,40088300,85736100,125824400,2.29,8.71,11
2021,3,07,04,1,26,제주특별자치도,5660,7514,13174,52489700,72413300,124903000,3.57,7.86,11
2021,3,07,11,2,27,제주특별자치도,3176,19769,22945,31249600,189576500,220826100,4,6.57,11
2021,3,07,18,3,28,제주특별자치도,7568,13025,20593,78294000,126576800,204870800,2.71,6.14,9
2021,3,07,25,4,29,제주특별자치도,3259,13230,16489,33846900,124543100,158390000,3.14,7.43,11
2021,3,08,01,5,30,제주특별자치도,11379,10190,21569,107051900,89173400,196225300,3.29,6,9
2021,3,08,08,1,31,제주특별자치도,11377,8787,20164,110253300,82932200,193185500,4,5.57,10
2021,3,08,15,2,32,제주특별자치도,22945,5683,28628,219938600,53269300,273207900,3.29,6,9
2021,3,08,22,3,33,제주특별자치도,17955,2951,20906,176658300,27976600,204634900,3,6.14,9
2021,3,08,29,4,34,제주특별자치도,12179,1420,13599,114944300,13035800,127980100,3.86,6.71,11
2021,3,09,05,1,35,제주특별자치도,6714,8895,15609,65147200,84559300,149706500,4,7.43,11
2021,3,09,12,2,36,제주특별자치도,4217,6039,10256,41397100,57611500,99008600,5.43,6.43,12
2021,3,09,19,3,37,제주특별자치도,7324,4708,12032,70164500,43362500,113527000,5.57,5.14,11
2021,3,09,26,4,38,제주특별자치도,10249,5779,16028,101860800,55241800,157102600,5,5.71,11
2021,4,10,03,5,39,제주특별자치도,4005,6334,10339,37282900,57746200,95029100,3.71,5.86,10
2021,4,10,10,1,40,제주특별자치도,3303,5414,8717,32059000,51080600,83139600,4.43,6.57,11
2021,4,10,17,2,41,제주특별자치도,2277,16136,18413,22902100,155172000,178074100,4.57,6.86,11
2021,4,10,24,3,42,제주특별자치도,847,10849,11696,8133300,105184700,113318000,4.57,6.14,11
2021,4,10,31,4,43,제주특별자치도,317,9289,9606,3046000,87043600,90089600,3.86,8,12
2021,4,11,07,1,44,제주특별자치도,95,22982,23077,824000,232329900,233153900,1.14,6,7
2021,4,11,14,2,45,제주특별자치도,2010,14299,16309,21951000,142835000,164786000,2.29,6.14,8
2021,4,11,21,3,46,제주특별자치도,4385,6772,11157,45365000,68237500,113602500,2.43,9,11
2021,4,11,28,4,47,제주특별자치도,7372,6595,13967,71812300,60595700,132408000,3.71,7.71,11
2021,4,12,05,1,48,제주특별자치도,6748,4607,11355,64566200,43766600,108332800,5,8,13
2021,4,12,12,2,49,제주특별자치도,3658,2858,6516,36543800,28223800,64767600,6.29,10.29,17
2021,4,12,19,3,50,제주특별자치도,1142,30779,31921,10755800,306230700,316986500,4.71,5.86,11
2021,4,12,26,4,51,제주특별자치도,598,28957,29555,5855000,287688900,293543900,3.57,5,9
2022,1,01,02,5,52,제주특별자치도,2194,19680,21874,20096000,184276000,204372000,2,5.14,7
2021,1,01,10,1,1,충청남도,744,3138,3882,6566840,27514810,34081650,5.57,23.29,29
2021,1,01,17,2,2,충청남도,609,3344,3953,5288360,29152680,34441040,5.29,23.57,29
2021,1,01,24,3,3,충청남도,296,14163,14459,2205580,125708020,127913600,6.71,21.86,29
2021,1,01,31,4,4,충청남도,1727,23209,24936,14042040,200277190,214319230,5.43,20.29,26
2021,1,02,07,1,5,충청남도,1273,21865,23138,10703350,199336420,210039770,4.86,19.29,24
2021,1,02,14,2,6,충청남도,6213,23449,29662,57820940,218367770,276188710,8.86,20.14,29
2021,1,02,21,3,7,충청남도,8764,11674,20438,80338980,107633220,187972200,9.57,23.14,33
2021,1,02,28,4,8,충청남도,8380,15676,24056,73456720,137742160,211198880,9.86,25,35
2021,1,03,07,1,9,충청남도,4380,22308,26688,42557190,205928790,248485980,8,19.86,28
2021,1,03,14,2,10,충청남도,1605,18013,19618,15823750,165052400,180876150,5.43,21.14,27
2021,1,03,21,3,11,충청남도,1212,16081,17293,13543580,148859350,162402930,5.71,26.29,32
2021,1,03,28,4,12,충청남도,5387,22588,27975,47585210,207790200,255375410,10.57,20.57,31
2021,2,04,04,1,13,충청남도,6851,15789,22640,58399830,143977580,202377410,10.14,20.29,30
2021,2,04,11,2,14,충청남도,3187,10757,13944,28564370,104673640,133238010,9.86,20.29,30
2021,2,04,18,3,15,충청남도,9232,9158,18390,88734560,89178640,177913200,8,19.57,28
2021,2,04,25,4,16,충청남도,9480,7877,17357,89714030,73652410,163366440,8.71,17.71,26
2021,2,05,02,5,17,충청남도,12156,11773,23929,110534890,105203380,215738270,12,21.14,33
2021,2,05,09,1,18,충청남도,10001,17887,27888,94426330,161371790,255798120,12.43,21.86,34
2021,2,05,16,2,19,충청남도,5182,10011,15193,49524280,92168380,141692660,10.86,23.86,35
2021,2,05,23,3,20,충청남도,2260,49615,51875,20449490,474749930,495199420,10.71,21.86,33
2021,2,05,30,4,21,충청남도,3819,33591,37410,34495770,309509280,344005050,9.86,21.86,32
2021,2,06,06,1,22,충청남도,2130,37088,39218,18644530,359063920,377708450,9.29,16.86,26
2021,2,06,13,2,23,충청남도,641,31312,31953,5194440,304204430,309398870,6.29,16.43,23
2021,2,06,20,3,24,충청남도,3025,33430,36455,26968680,329382290,356350970,4.14,17.71,22
2021,2,06,27,4,25,충청남도,13853,25967,39820,133997240,254725760,388723000,6.29,19.43,26
2021,3,07,04,1,26,충청남도,19813,22598,42411,185570800,214208720,399779520,7.71,18,26
2021,3,07,11,2,27,충청남도,8624,53629,62253,84981140,530665400,615646540,5.86,12.86,19
2021,3,07,18,3,28,충청남도,20181,35314,55495,211014410,348527600,559542010,5.71,13,19
2021,3,07,25,4,29,충청남도,8863,40178,49041,91416570,378761530,470178100,6.57,16.86,23
2021,3,08,01,5,30,충청남도,34699,28194,62893,332147090,255224970,587372060,4.86,12.43,17
2021,3,08,08,1,31,충청남도,35767,28648,64415,354754530,273780310,628534840,5,12.43,17
2021,3,08,15,2,32,충청남도,62795,13896,76691,610312990,132804460,743117450,6,11.29,17
2021,3,08,22,3,33,충청남도,71086,9427,80513,704250110,88487120,792737230,5.29,13.14,18
2021,3,08,29,4,34,충청남도,44202,4620,48822,429434810,42588770,472023580,5.71,15.86,22
2021,3,09,05,1,35,충청남도,21023,29128,50151,205709900,287052880,492762780,5.86,15.43,21
2021,3,09,12,2,36,충청남도,12059,19489,31548,120094620,192655070,312749690,9,15,24
2021,3,09,19,3,37,충청남도,23396,15434,38830,228858190,148315700,377173890,7.43,16.86,24
2021,3,09,26,4,38,충청남도,34346,18033,52379,342344740,177803210,520147950,7.29,13.57,21
2021,4,10,03,5,39,충청남도,11502,20883,32385,109454110,195859030,305313140,6.14,14.29,20
2021,4,10,10,1,40,충청남도,9760,16601,26361,95992940,162184850,258177790,7.57,14.14,22
2021,4,10,17,2,41,충청남도,5621,50045,55666,54178440,491495520,545673960,9.29,14.57,24
2021,4,10,24,3,42,충청남도,2449,33213,35662,21126340,326180540,347306880,9.43,17.29,27
2021,4,10,31,4,43,충청남도,1284,26831,28115,9390670,251363020,260753690,8.43,19.57,28
2021,4,11,07,1,44,충청남도,317,67189,67506,2625000,670178310,672803310,3.57,18.43,22
2021,4,11,14,2,45,충청남도,8004,41965,49969,82509290,412230490,494739780,5.14,20,25
2021,4,11,21,3,46,충청남도,17137,25114,42251,170740660,239710120,410450780,6,22.57,29
2021,4,11,28,4,47,충청남도,27940,20679,48619,268091200,183734450,451825650,8.86,20.57,29
2021,4,12,05,1,48,충청남도,19909,15111,35020,198316560,136839930,335156490,13.57,18.43,32
2021,4,12,12,2,49,충청남도,11201,9557,20758,111846200,89609160,201455360,13.43,19.86,33
2021,4,12,19,3,50,충청남도,3883,95220,99103,36424080,925524920,961949000,7.71,19.43,27
2021,4,12,26,4,51,충청남도,1327,85831,87158,10892910,836010990,846903900,3.86,20.43,24
2022,1,01,02,5,52,충청남도,6904,51612,58516,63396690,485486050,548882740,3.14,23.57,27
2021,1,01,10,1,1,충청북도,465,1942,2407,4324250,17293250,21617500,4,15.29,19
2021,1,01,17,2,2,충청북도,316,1906,2222,2898050,16736460,19634510,4.14,17.71,22
2021,1,01,24,3,3,충청북도,130,9331,9461,1080000,83585670,84665670,3.86,17.43,21
2021,1,01,31,4,4,충청북도,1159,15988,17147,9762320,132043280,141805600,4.71,13.57,18
2021,1,02,07,1,5,충청북도,815,15006,15821,7186680,135415790,142602470,5.29,14.29,20
2021,1,02,14,2,6,충청북도,4402,16756,21158,41393800,152712960,194106760,6.29,15.29,22
2021,1,02,21,3,7,충청북도,5940,8156,14096,55084490,73445070,128529560,6.71,16.29,23
2021,1,02,28,4,8,충청북도,5830,11129,16959,51183630,96979170,148162800,8,19.57,28
2021,1,03,07,1,9,충청북도,2946,16017,18963,28579350,143341410,171920760,6.43,16.14,23
2021,1,03,14,2,10,충청북도,925,13270,14195,8679230,118640060,127319290,3.14,16.71,20
2021,1,03,21,3,11,충청북도,680,12960,13640,7241440,114666630,121908070,4.29,21.43,26
2021,1,03,28,4,12,충청북도,3243,16464,19707,28540450,145942660,174483110,8.86,17.71,27
2021,2,04,04,1,13,충청북도,4512,10837,15349,38328020,95358040,133686060,9,17,26
2021,2,04,11,2,14,충청북도,2689,7927,10616,23758090,74812720,98570810,7.86,17.86,26
2021,2,04,18,3,15,충청북도,7312,7175,14487,68231060,66285160,134516220,5.29,16.14,21
2021,2,04,25,4,16,충청북도,7531,6120,13651,70705140,55637520,126342660,5.57,15.57,21
2021,2,05,02,5,17,충청북도,9375,9081,18456,84417140,81321480,165738620,6.14,16,22
2021,2,05,09,1,18,충청북도,7644,13768,21412,70438520,123084390,193522910,7.57,14.29,22
2021,2,05,16,2,19,충청북도,4062,8256,12318,37055610,77515390,114571000,8.57,15.57,24
2021,2,05,23,3,20,충청북도,1913,36616,38529,17589220,348192640,365781860,7.71,17.57,25
2021,2,05,30,4,21,충청북도,3082,25452,28534,27620130,233846920,261467050,8,15.57,24
2021,2,06,06,1,22,충청북도,1254,28093,29347,11473880,268827000,280300880,7.57,13.14,21
2021,2,06,13,2,23,충청북도,353,23403,23756,3187840,226472500,229660340,5.71,12.29,18
2021,2,06,20,3,24,충청북도,1835,26220,28055,17226870,251903210,269130080,3.29,12.86,16
2021,2,06,27,4,25,충청북도,10801,20572,31373,104819990,197681220,302501210,4,13.57,18
2021,3,07,04,1,26,충청북도,16132,17931,34063,148739710,166775770,315515480,6,14.86,21
2021,3,07,11,2,27,충청북도,7816,44718,52534,76119700,434828140,510947840,5.86,12.71,19
2021,3,07,18,3,28,충청북도,17249,30650,47899,175808910,301588540,477397450,5.43,11.71,17
2021,3,07,25,4,29,충청북도,7321,32084,39405,75219500,300563610,375783110,5.71,14,20
2021,3,08,01,5,30,충청북도,27301,20915,48216,255058660,185539920,440598580,5.71,11.71,17
2021,3,08,08,1,31,충청북도,28893,20118,49011,280631470,188347670,468979140,4.86,12.43,17
2021,3,08,15,2,32,충청북도,46500,10023,56523,447335040,94612390,541947430,4,10.86,15
2021,3,08,22,3,33,충청북도,55541,7446,62987,542519410,69290780,611810190,3.43,11.43,15
2021,3,08,29,4,34,충청북도,37070,3299,40369,353373080,29607470,382980550,4.71,14.71,19
2021,3,09,05,1,35,충청북도,18113,22407,40520,174683050,216706560,391389610,6,15.43,21
2021,3,09,12,2,36,충청북도,10987,15404,26391,107091870,149786860,256878730,7.57,13.43,21
2021,3,09,19,3,37,충청북도,18538,11813,30351,178077630,111410410,289488040,6.71,12.71,19
2021,3,09,26,4,38,충청북도,29833,14381,44214,292741360,137802880,430544240,5.86,12.29,18
2021,4,10,03,5,39,충청북도,9802,15234,25036,90259850,139566440,229826290,7.14,10.43,18
2021,4,10,10,1,40,충청북도,7327,12008,19335,71680340,114001250,185681590,8.14,12.57,21
2021,4,10,17,2,41,충청북도,4174,34402,38576,40165330,329479640,369644970,9.86,13.43,23
2021,4,10,24,3,42,충청북도,5905,26741,32646,45619400,250001760,295621160,9.43,11.86,21
2021,4,10,31,4,43,충청북도,1285,21405,22690,10396700,196055930,206452630,6.29,12,18
2021,4,11,07,1,44,충청북도,843,51657,52500,5711400,515769690,521481090,4.43,10.57,15
2021,4,11,14,2,45,충청북도,6568,33773,40341,69184140,331839180,401023320,3.29,10.43,14
2021,4,11,21,3,46,충청북도,13181,18465,31646,132452130,177565770,310017900,5.86,13.57,19
2021,4,11,28,4,47,충청북도,21769,14036,35805,208447370,129532600,337979970,6.71,14,21
2021,4,12,05,1,48,충청북도,14656,10471,25127,145499890,97008910,242508800,8.71,13.71,22
2021,4,12,12,2,49,충청북도,10673,7343,18016,99238990,68783590,168022580,10.57,16.57,27
2021,4,12,19,3,50,충청북도,3373,77351,80724,30171940,743760770,773932710,6.57,13.43,20
2021,4,12,26,4,51,충청북도,1000,67576,68576,9178570,647596990,656775560,3.43,11,14
2022,1,01,02,5,52,충청북도,5337,38922,44259,48403830,365277820,413681650,3.71,12.71,16
2022,1,01,09,1,1,강원도,9332,21810,31142,84517100,197312940,281830040,2.57,10.57,13
2022,1,01,16,2,2,강원도,9643,16253,25896,86614040,147015200,233629240,3.57,10.86,14
2022,1,01,23,3,3,강원도,6374,12619,18993,57700790,109350450,167051240,4.43,13.86,18
2022,1,01,30,4,4,강원도,20787,5887,26674,178929520,49346220,228275740,6.43,13,19
2022,1,02,06,1,5,강원도,23962,5481,29443,214262380,47680100,261942480,7.29,13.43,21
2022,1,02,13,2,6,강원도,6258,5267,11525,55516270,46798320,102314590,7.14,13.29,20
2022,1,02,20,3,7,강원도,2926,13519,16445,22625400,124551810,147177210,8.71,13.71,22
2022,1,02,27,4,8,강원도,2323,11476,13799,18398600,101226870,119625470,8,17.43,25
2022,1,03,06,1,9,강원도,1202,13976,15178,9065000,129225730,138290730,7.14,16.71,24
2022,1,03,13,2,10,강원도,6166,8672,14838,51766600,79831340,131597940,6,15,21
2022,1,03,20,3,11,강원도,3221,6590,9811,28137470,61154400,89291870,4.86,16.29,21
2022,1,03,27,4,12,강원도,6197,4237,10434,55240900,37906100,93147000,3.57,18.71,22
2022,2,04,03,5,13,강원도,3608,8598,12206,31162540,75912220,107074760,5.57,18,24
2022,2,04,10,1,14,강원도,2210,8415,10625,19105740,74765780,93871520,5.71,16.71,22
2022,2,04,17,2,15,강원도,1431,13393,14824,10681600,126979290,137660890,6.57,13.43,20
2022,2,04,24,3,16,강원도,4172,9127,13299,41642070,87418000,129060070,8.14,10.14,18
2022,2,05,01,4,17,강원도,10887,9101,19988,99608020,82420130,182028150,11.29,11.14,22
2022,2,05,08,1,18,강원도,4760,91028,95788,46609800,892580360,939190160,8.86,10.57,19
2022,2,05,15,2,19,강원도,6186,37940,44126,63611600,363442580,427054180,6.14,12.57,19
2022,2,05,22,3,20,강원도,84970,15962,100932,847068120,146775500,993843620,5.86,11.57,17
2022,2,05,29,4,21,강원도,82587,7889,90476,786260860,73574620,859835480,9.71,9.29,19
2022,2,06,05,1,22,강원도,62718,53084,115802,618201250,503153900,1121355150,7.14,9,16
2022,2,06,12,2,23,강원도,63776,26634,90410,610159320,248706000,858865320,6.71,7.86,15
2022,2,06,19,3,24,강원도,74303,9926,84229,713244620,91263970,804508590,8.29,8,16
2022,2,06,26,4,25,강원도,42118,34813,76931,403555230,343137470,746692700,11.71,5.43,17
2022,3,07,03,5,26,강원도,34177,42996,77173,317921620,411813340,729734960,11.57,8.43,20
2022,3,07,10,1,27,강원도,16185,73455,89640,157310200,706915640,864225840,8.14,10.43,19
2022,3,07,17,2,28,강원도,12215,50954,63169,117575500,483661440,601236940,7.86,14,22
2022,3,07,24,3,29,강원도,28942,48945,77887,272322679,454190160,726512839,7.86,12.14,20
2022,3,07,31,4,30,강원도,81466,32598,114064,749132528,300255054,1049387582,8.71,9.29,18
2022,3,08,07,1,31,강원도,103516,21261,124777,945701783,194720254,1140422037,6.57,6.43,13
2022,3,08,14,2,32,강원도,92897,14941,107838,861013514,137597191,998610705,6.86,9.29,16
2022,3,08,21,3,33,강원도,67005,15739,82744,626670995,149703145,776374140,7.71,12.14,20
2022,3,08,28,4,34,강원도,40994,7650,48644,376503782,71940409,448444191,9,12.57,22
2022,3,09,04,1,35,강원도,36845,4269,41114,325565428,42566464,368131892,9.14,13.14,22
2022,3,09,11,2,36,강원도,90152,3150,93302,857085440,31795157,888880597,10.71,9.86,21
2022,3,09,18,3,37,강원도,70123,2697,72820,667548824,26996793,694545617,11.71,10.57,22
2022,3,09,25,4,38,강원도,36803,3243,40046,343023128,38410998,381434126,14.57,9.57,24
2022,4,10,02,5,39,강원도,35605,7204,42809,317873584,74095184,391968768,12,7.71,20
2022,4,10,09,1,40,강원도,36053,10600,46653,324548507,106500145,431048652,13.43,8.71,22
2022,4,10,16,2,41,강원도,20564,11320,31884,173296699,109643631,282940330,13.86,12.86,27
2022,4,10,23,3,42,강원도,10601,16352,26953,86358737,153295301,239654038,14.29,11,25
2022,4,10,30,4,43,강원도,16055,9515,25570,139151751,86625913,225777664,12.71,11.14,24
2022,4,11,06,1,44,강원도,12391,6403,18794,111030938,58187610,169218548,11.14,13.43,25
2022,4,11,13,2,45,강원도,6371,31450,37821,53501650,296815520,350317170,12.43,14.14,27
2022,4,11,20,3,46,강원도,25268,19929,45197,223672078,182856536,406528614,12.86,14.86,28
2022,4,11,27,4,47,강원도,35406,11044,46450,318092815,94090417,412183232,12.71,13.29,26
2022,4,12,04,1,48,강원도,44942,10094,55036,392501898,83896216,476398114,13.57,13.14,27
2022,4,12,11,2,49,강원도,36320,8793,45113,315149143,82730353,397879496,14,16.14,30
2022,4,12,18,3,50,강원도,20332,81417,101749,170883963,912820247,1083704210,12.71,13.29,26
2022,4,12,25,4,51,강원도,36366,85890,122256,316881523,994265682,1311147205,9,11.29,20
2023,1,01,01,5,52,강원도,36244,58341,94585,316163002,677248898,993411900,10.43,11.14,22
2022,1,01,09,1,1,경기도,99320,263061,362381,985063390,2625559630,3610623020,8,17.57,26
2022,1,01,16,2,2,경기도,101199,204552,305751,1022672970,2019690680,3042363650,7.86,17,25
2022,1,01,23,3,3,경기도,65972,158756,224728,665537410,1468834340,2134371750,8.43,22.29,31
2022,1,01,30,4,4,경기도,206488,73322,279810,1978937430,652274900,2631212330,10.86,22.71,34
2022,1,02,06,1,5,경기도,266274,75466,341740,2657405330,689330620,3346735950,11.14,19.57,31
2022,1,02,13,2,6,경기도,62565,76767,139332,607922830,764705010,1372627840,10,22.14,32
2022,1,02,20,3,7,경기도,29315,169776,199091,237987260,1685210350,1923197610,11,21.43,32
2022,1,02,27,4,8,경기도,24772,137627,162399,202033470,1313774750,1515808220,12,28.14,40
2022,1,03,06,1,9,경기도,10534,197960,208494,84276530,2007623240,2091899770,10.14,25.86,36
2022,1,03,13,2,10,경기도,61872,108734,170606,595477370,1095515200,1690992570,9.29,23,32
2022,1,03,20,3,11,경기도,36231,87583,123814,345567890,880700140,1226268030,8.86,24.71,34
2022,1,03,27,4,12,경기도,69689,54400,124089,677409680,523776010,1201185690,7.43,29,36
2022,2,04,03,5,13,경기도,36359,111069,147428,338931800,1060467240,1399399040,9,30.57,40
2022,2,04,10,1,14,경기도,22571,102966,125537,212628180,1007055850,1219684030,8.86,31.71,41
2022,2,04,17,2,15,경기도,12278,171594,183872,107281130,1767096850,1874377980,9.57,26.14,36
2022,2,04,24,3,16,경기도,45712,120510,166222,497857970,1233064210,1730922180,15,23.57,39
2022,2,05,01,4,17,경기도,111245,120284,231529,1074281840,1143930480,2218212320,16.86,24.86,42
2022,2,05,08,1,18,경기도,41559,1100755,1142314,419996150,11692473260,12112469410,11.43,18,29
2022,2,05,15,2,19,경기도,65283,407591,472874,694804460,4383961400,5078765860,11,17.71,29
2022,2,05,22,3,20,경기도,886993,172509,1059502,9426337660,1773407570,11199745230,11.14,21.57,33
2022,2,05,29,4,21,경기도,826256,86394,912650,8512713760,892856630,9405570390,12.14,19.29,31
2022,2,06,05,1,22,경기도,645971,598905,1244876,6667857300,6195745780,12863603080,12.43,16.29,29
2022,2,06,12,2,23,경기도,638604,282632,921236,6628238120,2908520910,9536759030,9,11.71,21
2022,2,06,19,3,24,경기도,707376,127999,835375,7377355330,1339676680,8717032010,12.71,13.57,26
2022,2,06,26,4,25,경기도,370798,421422,792220,3883937580,4618550340,8502487920,14.43,12.57,27
2022,3,07,03,5,26,경기도,327808,500309,828117,3326018480,5376120980,8702139460,14.43,16,30
2022,3,07,10,1,27,경기도,168259,868818,1037077,1781823760,9403704790,11185528550,12.57,17.14,30
2022,3,07,17,2,28,경기도,123858,560198,684056,1322008020,6017927590,7339935610,11.57,18.86,30
2022,3,07,24,3,29,경기도,299193,526640,825833,3228397135,5487343906,8715741041,10.57,16.57,27
2022,3,07,31,4,30,경기도,778595,366784,1145379,8134297643,3705301180,11839598823,10.86,13.86,25
2022,3,08,07,1,31,경기도,1054472,263624,1318096,10930333475,2659690706,13590024181,12.29,14.29,27
2022,3,08,14,2,32,경기도,845609,147378,992987,8862676435,1503815236,10366491671,11.57,13.71,25
2022,3,08,21,3,33,경기도,669570,186837,856407,7060154855,2017325309,9077480164,13,17.43,30
2022,3,08,28,4,34,경기도,360651,97372,458023,3735843302,1065899226,4801742528,15.29,19,34
2022,3,09,04,1,35,경기도,313097,55358,368455,3087477131,606735817,3694212948,15,19.29,34
2022,3,09,11,2,36,경기도,873702,51628,925330,9168167150,586895472,9755062622,16,15.57,32
2022,3,09,18,3,37,경기도,663885,37127,701012,6963732095,420076248,7383808343,19.29,16.57,36
2022,3,09,25,4,38,경기도,338321,41696,380017,3521988247,601927267,4123915514,21.57,15.57,37
2022,4,10,02,5,39,경기도,344093,63223,407316,3416651027,804853530,4221504557,20,15.29,35
2022,4,10,09,1,40,경기도,334594,98602,433196,3334449942,1114981850,4449431792,21.57,17.29,39
2022,4,10,16,2,41,경기도,195336,107395,302731,1836105903,1148081939,2984187842,22.14,24.14,46
2022,4,10,23,3,42,경기도,101299,178777,280076,913388049,1857248679,2770636728,22,21.29,43
2022,4,10,30,4,43,경기도,159454,104202,263656,1516284757,1055124954,2571409711,20.29,23.86,44
2022,4,11,06,1,44,경기도,127440,66001,193441,1253731433,672296095,1926027528,25.29,23.29,49
2022,4,11,13,2,45,경기도,53321,315043,368364,525741662,3403308186,3929049848,19,19.14,38
2022,4,11,20,3,46,경기도,202813,199029,401842,2032936931,2112509984,4145446915,18.14,20.43,39
2022,4,11,27,4,47,경기도,328323,104041,432364,3320646676,1084820508,4405467184,18.43,21.57,40
2022,4,12,04,1,48,경기도,429700,81603,511303,4243272102,808498364,5051770466,19.86,23.14,43
2022,4,12,11,2,49,경기도,306351,80254,386605,3052534586,845041883,3897576469,18.86,27.71,47
2022,4,12,18,3,50,경기도,169328,790451,959779,1679473215,9770193684,11449666899,14.29,24.86,39
2022,4,12,25,4,51,경기도,315399,848311,1163710,3200495396,10680673721,13881169117,14.29,16.43,31
2023,1,01,01,5,52,경기도,343275,641395,984670,3378047591,8105211802,11483259393,13,14.43,27
2022,1,01,09,1,1,경상남도,21610,41668,63278,198080430,380687170,578767600,5,9.86,15
2022,1,01,16,2,2,경상남도,21997,29422,51419,207915140,269241360,477156500,4.29,11.57,16
2022,1,01,23,3,3,경상남도,14476,23927,38403,134537230,206856120,341393350,3.43,18.57,22
2022,1,01,30,4,4,경상남도,43490,9241,52731,389570140,77276060,466846200,7.57,15.43,23
2022,1,02,06,1,5,경상남도,56169,8903,65072,528938630,78037000,606975630,8.14,11,19
2022,1,02,13,2,6,경상남도,13264,10689,23953,121534520,97576470,219110990,6.71,13.29,20
2022,1,02,20,3,7,경상남도,6280,26967,33247,47569400,246749040,294318440,7.14,14,21
2022,1,02,27,4,8,경상남도,4775,23132,27907,38304800,204310700,242615500,9.43,17.43,27
2022,1,03,06,1,9,경상남도,1888,27672,29560,15011600,256920230,271931830,7,14.29,21
2022,1,03,13,2,10,경상남도,11892,15514,27406,107388000,143433960,250821960,4.14,11,15
2022,1,03,20,3,11,경상남도,6911,13289,20200,62222300,123791980,186014280,3.43,14,17
2022,1,03,27,4,12,경상남도,17770,8107,25877,165977320,72867900,238845220,2.71,17.43,20
2022,2,04,03,5,13,경상남도,10206,16159,26365,93316200,143892480,237208680,5.14,17.86,23
2022,2,04,10,1,14,경상남도,7341,18833,26174,68228800,173166040,241394840,6.14,14.71,21
2022,2,04,17,2,15,경상남도,2936,27388,30324,26810700,258698660,285509360,7.86,14.29,22
2022,2,04,24,3,16,경상남도,9764,19858,29622,98023620,187487560,285511180,8.14,13.57,22
2022,2,05,01,4,17,경상남도,26864,20407,47271,245415200,182318860,427734060,12.29,17.57,30
2022,2,05,08,1,18,경상남도,9937,186481,196418,94039380,1811109280,1905148660,9.29,13.29,23
2022,2,05,15,2,19,경상남도,14575,70519,85094,145596000,686157670,831753670,7.43,15.29,23
2022,2,05,22,3,20,경상남도,185425,28039,213464,1839681120,271947900,2111629020,8,11.14,19
2022,2,05,29,4,21,경상남도,173210,14522,187732,1659936330,138512200,1798448530,10.43,9.14,20
2022,2,06,05,1,22,경상남도,132288,135293,267581,1291410480,1287302780,2578713260,7.43,8.43,16
2022,2,06,12,2,23,경상남도,129522,59984,189506,1258060360,566098200,1824158560,6.43,8,14
2022,2,06,19,3,24,경상남도,145978,21730,167708,1435562440,209562050,1645124490,7.71,9.14,17
2022,2,06,26,4,25,경상남도,81024,82304,163328,800769420,823962430,1624731850,9.57,8.14,18
2022,3,07,03,5,26,경상남도,68384,95710,164094,656285500,936063220,1592348720,10.14,8,18
2022,3,07,10,1,27,경상남도,30901,147846,178747,308412740,1469201780,1777614520,8,9.86,18
2022,3,07,17,2,28,경상남도,21595,98972,120567,217630660,984829720,1202460380,8.29,10.14,18
2022,3,07,24,3,29,경상남도,61808,99939,161747,612716380,966050790,1578767170,8.71,11.29,20
2022,3,07,31,4,30,경상남도,184575,65804,250379,1782581358,622512960,2405094318,6.86,10.57,17
2022,3,08,07,1,31,경상남도,261683,54742,316425,2529459736,517442133,3046901869,7.43,7.71,15
2022,3,08,14,2,32,경상남도,200763,31149,231912,1966378051,291630590,2258008641,8.14,10.29,18
2022,3,08,21,3,33,경상남도,146062,30959,177021,1437739658,302390133,1740129791,8.71,12.57,21
2022,3,08,28,4,34,경상남도,83255,14171,97426,810507277,142849412,953356689,9.29,10.86,20
2022,3,09,04,1,35,경상남도,74256,7442,81698,692621186,75099096,767720282,10.14,12.57,23
2022,3,09,11,2,36,경상남도,195286,5977,201263,1944233320,64307591,2008540911,11.57,8.86,20
2022,3,09,18,3,37,경상남도,148676,5018,153694,1461372137,50961693,1512333830,11.71,10.43,22
2022,3,09,25,4,38,경상남도,74103,6390,80493,719370699,83341157,802711856,11.86,10,22
2022,4,10,02,5,39,경상남도,73048,14792,87840,681970837,159200081,841170918,12.14,8.57,21
2022,4,10,09,1,40,경상남도,68816,21620,90436,646995797,217684064,864679861,13.57,10,24
2022,4,10,16,2,41,경상남도,40315,19638,59953,356999347,192692529,549691876,14.86,14.29,29
2022,4,10,23,3,42,경상남도,19433,29424,48857,167624748,286675481,454300229,15,13,28
2022,4,10,30,4,43,경상남도,31927,16293,48220,289586468,153076228,442662696,12.14,12.71,25
2022,4,11,06,1,44,경상남도,28004,10399,38403,259053417,99146573,358199990,14,13.71,28
2022,4,11,13,2,45,경상남도,11866,56253,68119,109581682,551095324,660677006,11.86,15.43,27
2022,4,11,20,3,46,경상남도,45777,33306,79083,432359204,323248063,755607267,11.43,11.43,23
2022,4,11,27,4,47,경상남도,65756,16241,81997,625373132,151963363,777336495,11.86,13,25
2022,4,12,04,1,48,경상남도,85965,14576,100541,789233533,131627472,920861005,14.57,15.43,30
2022,4,12,11,2,49,경상남도,64659,18034,82693,600502891,173779697,774282588,15.29,17.71,33
2022,4,12,18,3,50,경상남도,34655,162440,197095,320962930,1795479107,2116442037,11.86,12.71,25
2022,4,12,25,4,51,경상남도,60230,166910,227140,573180159,1913020419,2486200578,8.29,9.29,18
2023,1,01,01,5,52,경상남도,69135,130277,199412,638868084,1496052007,2134920091,8.29,10.14,18
2022,1,01,09,1,1,경상북도,14854,28736,43590,142040010,265684380,407724390,4.71,9.57,14
2022,1,01,16,2,2,경상북도,15854,20386,36240,151894370,188666640,340561010,3.43,10.29,14
2022,1,01,23,3,3,경상북도,10663,16245,26908,100554320,140038370,240592690,3.29,16.43,20
2022,1,01,30,4,4,경상북도,29466,6411,35877,266201440,54034300,320235740,6.29,12.43,19
2022,1,02,06,1,5,경상북도,36366,5207,41573,351051080,45713320,396764400,6.71,8.57,15
2022,1,02,13,2,6,경상북도,8758,6330,15088,82370900,57260360,139631260,7.86,12.71,21
2022,1,02,20,3,7,경상북도,4572,17837,22409,34724100,164600540,199324640,9.43,14.14,24
2022,1,02,27,4,8,경상북도,3352,15285,18637,25896400,136955490,162851890,10,18.86,29
2022,1,03,06,1,9,경상북도,1742,17425,19167,12533900,163734530,176268430,8.43,15,23
2022,1,03,13,2,10,경상북도,7942,10311,18253,73729200,97157700,170886900,7,13.71,21
2022,1,03,20,3,11,경상북도,4855,8845,13700,44212700,81837760,126050460,5.71,17.71,23
2022,1,03,27,4,12,경상북도,11614,4731,16345,110261000,43129160,153390160,5.71,17.71,23
2022,2,04,03,5,13,경상북도,6597,10803,17400,59115100,96546310,155661410,6.29,15.71,22
2022,2,04,10,1,14,경상북도,4991,10713,15704,45229320,99913800,145143120,7.57,15.43,23
2022,2,04,17,2,15,경상북도,2539,16146,18685,22419900,154793240,177213140,8.57,13.57,22
2022,2,04,24,3,16,경상북도,6291,11858,18149,60456170,110645000,171101170,9.71,13.57,23
2022,2,05,01,4,17,경상북도,16203,11568,27771,148907760,103431200,252338960,10.29,14.86,25
2022,2,05,08,1,18,경상북도,7932,118198,126130,75241300,1155141450,1230382750,9.43,12.29,22
2022,2,05,15,2,19,경상북도,11343,47067,58410,112452000,461684320,574136320,8.14,11.86,20
2022,2,05,22,3,20,경상북도,130316,19350,149666,1322532260,185210960,1507743220,7.43,11.43,19
2022,2,05,29,4,21,경상북도,123870,11203,135073,1224333250,104432060,1328765310,9.29,9.71,19
2022,2,06,05,1,22,경상북도,91675,80444,172119,926292800,777809560,1704102360,8.71,9.86,19
2022,2,06,12,2,23,경상북도,89523,38276,127799,905509240,365223460,1270732700,8.14,7.57,16
2022,2,06,19,3,24,경상북도,105657,14217,119874,1071419620,134744510,1206164130,6.29,8.71,15
2022,2,06,26,4,25,경상북도,59481,49903,109384,601733960,499555640,1101289600,11.29,7.86,19
2022,3,07,03,5,26,경상북도,43340,53331,96671,426408840,524502920,950911760,10.57,9,20
2022,3,07,10,1,27,경상북도,20856,92416,113272,209670680,923713810,1133384490,8.43,9.71,18
2022,3,07,17,2,28,경상북도,15113,65024,80137,152992500,655579000,808571500,9.57,12,22
2022,3,07,24,3,29,경상북도,40616,63492,104108,409080929,626043917,1035124846,10,9.57,20
2022,3,07,31,4,30,경상북도,113302,43382,156684,1109007147,414061832,1523068979,10.86,7.71,19
2022,3,08,07,1,31,경상북도,156141,31461,187602,1544821672,300554053,1845375725,7.86,6.71,15
2022,3,08,14,2,32,경상북도,123710,17049,140759,1241298511,163673138,1404971649,9,9.14,18
2022,3,08,21,3,33,경상북도,93320,19588,112908,942633048,191410933,1134043981,9.43,12.71,22
2022,3,08,28,4,34,경상북도,56003,8829,64832,557562528,85906294,643468822,11.71,12.29,24
2022,3,09,04,1,35,경상북도,49562,4425,53987,469537082,40620596,510157678,11.14,12.43,24
2022,3,09,11,2,36,경상북도,123217,3476,126693,1244517936,31463299,1275981235,11.29,9.57,21
2022,3,09,18,3,37,경상북도,97582,2261,99843,973190494,21136398,994326892,11.29,9.43,21
2022,3,09,25,4,38,경상북도,51527,2694,54221,517177674,30654300,547831974,13,8.86,22
2022,4,10,02,5,39,경상북도,47187,8118,55305,454647321,77015487,531662808,11.14,5.86,17
2022,4,10,09,1,40,경상북도,47655,13924,61579,454438861,135814099,590252960,14.86,6.57,21
2022,4,10,16,2,41,경상북도,27822,14745,42567,252985036,143939297,396924333,14.14,7.43,22
2022,4,10,23,3,42,경상북도,13156,19110,32266,116383636,188469943,304853579,14.29,8.71,23
2022,4,10,30,4,43,경상북도,21587,10814,32401,200532278,101652362,302184640,13,9.71,23
2022,4,11,06,1,44,경상북도,18410,7826,26236,172005044,72316371,244321415,10.86,13,24
2022,4,11,13,2,45,경상북도,7578,36746,44324,71963472,358102582,430066054,10.57,10.71,21
2022,4,11,20,3,46,경상북도,36410,24631,61041,344680464,232844534,577524998,12.71,9.71,22
2022,4,11,27,4,47,경상북도,46182,12967,59149,438541598,114728424,553270022,12.57,9.57,22
2022,4,12,04,1,48,경상북도,57162,11558,68720,528319557,99712764,628032321,12.57,10.29,23
2022,4,12,11,2,49,경상북도,42335,8989,51324,403984700,80742068,484726768,13.86,12,26
2022,4,12,18,3,50,경상북도,26373,100147,126520,239909672,1043700980,1283610652,11.57,8.86,20
2022,4,12,25,4,51,경상북도,44376,111082,155458,419516660,1179639306,1599155966,10.57,7.14,18
2023,1,01,01,5,52,경상북도,52138,78107,130245,480879083,822644580,1303523663,11.43,7.29,19
2022,1,01,09,1,1,광주광역시,16440,27545,43985,153324140,268767880,422092020,6.71,10.43,17
2022,1,01,16,2,2,광주광역시,16765,18335,35100,162028430,172994640,335023070,7.43,12.71,20
2022,1,01,23,3,3,광주광역시,11378,13740,25118,110997040,123454360,234451400,8.14,18.14,26
2022,1,01,30,4,4,광주광역시,29333,6447,35780,267456430,55778900,323235330,10.29,12.14,22
2022,1,02,06,1,5,광주광역시,35403,6033,41436,338267040,52912000,391179040,10.29,9.57,20
2022,1,02,13,2,6,광주광역시,10011,8395,18406,92581940,82257520,174839460,10.14,15.43,26
2022,1,02,20,3,7,광주광역시,5421,20146,25567,42555460,189367970,231923430,10.43,13,23
2022,1,02,27,4,8,광주광역시,4712,16036,20748,36913300,146671110,183584410,10.43,16.86,27
2022,1,03,06,1,9,광주광역시,2350,20771,23121,18581400,201370540,219951940,9.71,15.71,25
2022,1,03,13,2,10,광주광역시,8560,12321,20881,79020340,118572330,197592670,8.86,14,23
2022,1,03,20,3,11,광주광역시,5295,9920,15215,49503700,95877300,145381000,6.29,16.71,23
2022,1,03,27,4,12,광주광역시,10975,6336,17311,101397860,57794700,159192560,6.14,18.57,25
2022,2,04,03,5,13,광주광역시,5621,12436,18057,49919600,113304070,163223670,7.14,17.14,24
2022,2,04,10,1,14,광주광역시,5365,11989,17354,48378200,113322980,161701180,8.14,17.57,26
2022,2,04,17,2,15,광주광역시,2906,19340,22246,26405920,194652920,221058840,8.57,13.57,22
2022,2,04,24,3,16,광주광역시,8816,13455,22271,91195300,134822800,226018100,10.86,9.71,21
2022,2,05,01,4,17,광주광역시,19476,13943,33419,177536240,126962020,304498260,13.29,11.14,24
2022,2,05,08,1,18,광주광역시,10520,122434,132954,98749400,1264148360,1362897760,11.43,10.86,22
2022,2,05,15,2,19,광주광역시,11559,49797,61356,110155160,518891120,629046280,9.57,12.29,22
2022,2,05,22,3,20,광주광역시,128084,21146,149230,1280026380,210958160,1490984540,7.86,12.71,21
2022,2,05,29,4,21,광주광역시,109372,9417,118789,1062264150,95265590,1157529740,10.14,8.14,18
2022,2,06,05,1,22,광주광역시,85826,78872,164698,844268010,775522580,1619790590,10.14,8.57,19
2022,2,06,12,2,23,광주광역시,79712,35560,115272,775988580,347609960,1123598540,8.14,6.43,15
2022,2,06,19,3,24,광주광역시,96919,12996,109915,956276800,129663510,1085940310,9.86,6.43,16
2022,2,06,26,4,25,광주광역시,59157,47973,107130,575456150,507966680,1083422830,12,5.71,18
2022,3,07,03,5,26,광주광역시,40802,54262,95064,393371550,566600080,959971630,12.57,7.86,20
2022,3,07,10,1,27,광주광역시,23937,97796,121733,236725470,1021669330,1258394800,10.29,9,19
2022,3,07,17,2,28,광주광역시,18286,68127,86413,179677980,695712520,875390500,11.29,11.71,23
2022,3,07,24,3,29,광주광역시,41736,62454,104190,411925219,601930242,1013855461,10.14,11.71,22
2022,3,07,31,4,30,광주광역시,107667,40663,148330,1063476350,383637861,1447114211,11.29,10.29,22
2022,3,08,07,1,31,광주광역시,150552,32943,183495,1448346760,309896966,1758243726,10.14,9.29,19
2022,3,08,14,2,32,광주광역시,121729,17455,139184,1179844448,169999271,1349843719,9.14,13,22
2022,3,08,21,3,33,광주광역시,96556,22722,119278,948143239,232748744,1180891983,10.29,15.57,26
2022,3,08,28,4,34,광주광역시,55675,12729,68404,531117418,130857874,661975292,11.86,13.57,25
2022,3,09,04,1,35,광주광역시,48173,7929,56102,449294750,83783196,533077946,13.86,14,28
2022,3,09,11,2,36,광주광역시,126115,7377,133492,1230103285,83291894,1313395179,13.57,11,25
2022,3,09,18,3,37,광주광역시,105608,5880,111488,1028100550,63184988,1091285538,13.57,15.71,29
2022,3,09,25,4,38,광주광역시,52069,6159,58228,515764793,86401739,602166532,15.29,9.86,25
2022,4,10,02,5,39,광주광역시,47882,8493,56375,451621007,104567606,556188613,16.86,7.29,24
2022,4,10,09,1,40,광주광역시,45870,14142,60012,434739097,146777230,581516327,19.43,8,27
2022,4,10,16,2,41,광주광역시,28354,16585,44939,256762985,160713777,417476762,21.57,13,35
2022,4,10,23,3,42,광주광역시,15049,22212,37261,126646944,218224193,344871137,17.43,13.86,31
2022,4,10,30,4,43,광주광역시,24319,13387,37706,219061692,130029190,349090882,14.43,14.86,29
2022,4,11,06,1,44,광주광역시,20888,7398,28286,192855993,71857698,264713691,17,13.43,30
2022,4,11,13,2,45,광주광역시,9280,37651,46931,86371564,402106842,488478406,13.43,10.43,24
2022,4,11,20,3,46,광주광역시,37442,24826,62268,343101373,259414830,602516203,12.43,10.86,23
2022,4,11,27,4,47,광주광역시,47992,11079,59071,453240467,110701166,563941633,13.57,12.29,26
2022,4,12,04,1,48,광주광역시,61662,9431,71093,579429441,93696552,673125993,15.14,12,27
2022,4,12,11,2,49,광주광역시,42271,11491,53762,401655857,110735724,512391581,15.71,15.71,31
2022,4,12,18,3,50,광주광역시,24448,88231,112679,229338938,1067789523,1297128461,11.86,12.43,24
2022,4,12,25,4,51,광주광역시,35226,96365,131591,339186983,1186458023,1525645006,9.43,10.57,20
2023,1,01,01,5,52,광주광역시,44903,79690,124593,418201822,985777270,1403979092,11,11.29,22
2022,1,01,09,1,1,대구광역시,20582,40916,61498,198270540,390238330,588508870,5.43,12.71,18
2022,1,01,16,2,2,대구광역시,21688,31330,53018,217872420,300306160,518178580,4.86,14.29,19
2022,1,01,23,3,3,대구광역시,14499,23976,38475,143979100,212601640,356580740,6.57,19.43,26
2022,1,01,30,4,4,대구광역시,38309,10781,49090,356366350,93340820,449707170,8.29,15,23
2022,1,02,06,1,5,대구광역시,44547,9763,54310,438875220,86620980,525496200,8.57,11.43,20
2022,1,02,13,2,6,대구광역시,12152,12667,24819,117319860,119440780,236760640,8.43,16.57,25
2022,1,02,20,3,7,대구광역시,5810,30046,35856,46167960,284993020,331160980,10.29,16.57,27
2022,1,02,27,4,8,대구광역시,5235,25713,30948,42053660,236531800,278585460,9.29,23.14,32
2022,1,03,06,1,9,대구광역시,2545,31518,34063,20718300,304065980,324784280,8.43,17.43,26
2022,1,03,13,2,10,대구광역시,11744,18987,30731,110595680,181212820,291808500,8.57,17.14,26
2022,1,03,20,3,11,대구광역시,7019,15306,22325,65153060,147528200,212681260,5.86,20.57,26
2022,1,03,27,4,12,대구광역시,16439,9159,25598,157088020,85913470,243001490,5.29,22.43,28
2022,2,04,03,5,13,대구광역시,8613,17894,26507,79675800,163495250,243171050,5,23,28
2022,2,04,10,1,14,대구광역시,6603,16847,23450,62654000,157942500,220596500,6.29,22.14,28
2022,2,04,17,2,15,대구광역시,3501,25500,29001,33266320,249017740,282284060,8,16.57,25
2022,2,04,24,3,16,대구광역시,10554,19064,29618,111832920,184457020,296289940,13.29,15,28
2022,2,05,01,4,17,대구광역시,22322,17911,40233,212859000,165524180,378383180,15.43,15.86,31
2022,2,05,08,1,18,대구광역시,8445,172850,181295,86005000,1720740120,1806745120,9.57,12.86,22
2022,2,05,15,2,19,대구광역시,11768,65677,77445,122121300,656093900,778215200,8.14,12.57,21
2022,2,05,22,3,20,대구광역시,164782,25496,190278,1667355090,255067340,1922422430,6.86,10.86,18
2022,2,05,29,4,21,대구광역시,155193,13681,168874,1523488280,133278560,1656766840,8.57,10.43,19
2022,2,06,05,1,22,대구광역시,120942,101121,222063,1208827500,993340370,2202167870,9.14,10,19
2022,2,06,12,2,23,대구광역시,112976,47542,160518,1131981800,461043350,1593025150,8,7.57,16
2022,2,06,19,3,24,대구광역시,132227,19971,152198,1346645590,198080580,1544726170,10.43,6.86,17
2022,2,06,26,4,25,대구광역시,74924,78169,153093,771036780,814942700,1585979480,13.29,7.71,21
2022,3,07,03,5,26,대구광역시,59598,88571,148169,587261880,897330330,1484592210,12.29,9.43,22
2022,3,07,10,1,27,대구광역시,30251,141259,171510,312199200,1450988780,1763187980,10.14,11.29,21
2022,3,07,17,2,28,대구광역시,22164,100354,122518,228867780,1036843080,1265710860,9.57,13.57,23
2022,3,07,24,3,29,대구광역시,56616,89891,146507,594385729,905282418,1499668147,8.43,12,20
2022,3,07,31,4,30,대구광역시,145903,63847,209750,1459407050,623267949,2082674999,9,9.71,19
2022,3,08,07,1,31,대구광역시,206713,46354,253067,2055300902,453659244,2508960146,9.29,9.43,19
2022,3,08,14,2,32,대구광역시,157433,24130,181563,1592175122,238587263,1830762385,10.71,11.86,23
2022,3,08,21,3,33,대구광역시,122001,28964,150965,1246553162,297144690,1543697852,11.29,13.14,24
2022,3,08,28,4,34,대구광역시,73520,16878,90398,723310696,174996096,898306792,12,12.14,24
2022,3,09,04,1,35,대구광역시,64310,10979,75289,611153733,113560322,724714055,13.14,15.43,29
2022,3,09,11,2,36,대구광역시,163555,7567,171122,1680773455,79992818,1760766273,13,11.71,25
2022,3,09,18,3,37,대구광역시,125741,5649,131390,1301922250,61053796,1362976046,15.43,11.71,27
2022,3,09,25,4,38,대구광역시,64258,7572,71830,657566990,96289537,753856527,18.29,9.86,28
2022,4,10,02,5,39,대구광역시,66854,13294,80148,638175564,148578660,786754224,16.71,8.71,25
2022,4,10,09,1,40,대구광역시,59702,20925,80627,581801070,216574562,798375632,18.86,10.71,30
2022,4,10,16,2,41,대구광역시,36525,22082,58607,339624139,222245833,561869972,23.14,16.29,39
2022,4,10,23,3,42,대구광역시,18284,28320,46604,159153751,283201362,442355113,16.86,19.57,36
2022,4,10,30,4,43,대구광역시,30861,17351,48212,286468508,170411033,456879541,15.86,20.43,36
2022,4,11,06,1,44,대구광역시,26178,12683,38861,250821610,124221462,375043072,18.57,19.43,38
2022,4,11,13,2,45,대구광역시,12505,52804,65309,119877470,529095530,648973000,15,14.43,29
2022,4,11,20,3,46,대구광역시,42496,33262,75758,411453321,331578684,743032005,13.86,15.14,29
2022,4,11,27,4,47,대구광역시,59963,15782,75745,580969994,153275120,734245114,15.29,15.29,31
2022,4,12,04,1,48,대구광역시,78126,15741,93867,747822956,148138109,895961065,16.29,13.43,30
2022,4,12,11,2,49,대구광역시,57258,18212,75470,548977167,179021417,727998584,16.14,16.57,33
2022,4,12,18,3,50,대구광역시,29794,134850,164644,284682545,1525190637,1809873182,11.14,13.57,25
2022,4,12,25,4,51,대구광역시,51286,151295,202581,499787013,1753790082,2253577095,10.43,11,21
2023,1,01,01,5,52,대구광역시,60169,120915,181084,567144462,1428849372,1995993834,10,13,23
2022,1,01,09,1,1,대전광역시,15609,33412,49021,156177780,331409530,487587310,4.43,12.86,17
2022,1,01,16,2,2,대전광역시,15540,25667,41207,158218540,252635820,410854360,4.71,14.71,19
2022,1,01,23,3,3,대전광역시,10007,20165,30172,101121400,185573030,286694430,5.14,20.14,25
2022,1,01,30,4,4,대전광역시,31165,9047,40212,296400580,79424240,375824820,7.29,16.57,24
2022,1,02,06,1,5,대전광역시,36078,8482,44560,360477670,76695540,437173210,8.14,13.14,21
2022,1,02,13,2,6,대전광역시,8627,10341,18968,84015840,103134350,187150190,6.14,17.57,24
2022,1,02,20,3,7,대전광역시,3985,22398,26383,31046600,220908250,251954850,8.57,14.43,23
2022,1,02,27,4,8,대전광역시,3809,18317,22126,30985480,174372680,205358160,9.71,20.57,30
2022,1,03,06,1,9,대전광역시,1796,25563,27359,13875500,260985210,274860710,8.57,17.86,26
2022,1,03,13,2,10,대전광역시,9233,14625,23858,89475330,146905850,236381180,6.14,15.29,21
2022,1,03,20,3,11,대전광역시,5942,11836,17778,55444080,117307610,172751690,4.14,18.29,22
2022,1,03,27,4,12,대전광역시,10964,7287,18251,107249270,69491200,176740470,4.43,20.14,25
2022,2,04,03,5,13,대전광역시,5508,15300,20808,51116790,143926960,195043750,5.57,21.14,27
2022,2,04,10,1,14,대전광역시,3625,12718,16343,33687620,124968820,158656440,7,21,28
2022,2,04,17,2,15,대전광역시,2085,22467,24552,19278040,231569220,250847260,7.29,17.57,25
2022,2,04,24,3,16,대전광역시,7857,15915,23772,85312000,161913780,247225780,9.14,14.86,24
2022,2,05,01,4,17,대전광역시,16547,16309,32856,159900150,153497790,313397940,13.43,15.29,29
2022,2,05,08,1,18,대전광역시,6986,142983,149969,69255860,1526207150,1595463010,11.14,12.57,24
2022,2,05,15,2,19,대전광역시,10230,55624,65854,105575550,593924630,699500180,7.86,12.14,20
2022,2,05,22,3,20,대전광역시,125698,22761,148459,1328168440,232032270,1560200710,6,11.43,17
2022,2,05,29,4,21,대전광역시,113913,11083,124996,1158492060,112117530,1270609590,7.57,9.29,17
2022,2,06,05,1,22,대전광역시,86482,79925,166407,890345040,824569650,1714914690,7.14,9.14,16
2022,2,06,12,2,23,대전광역시,78063,34189,112252,808397430,350104140,1158501570,7,8.14,15
2022,2,06,19,3,24,대전광역시,95071,15298,110369,991506110,158848880,1150354990,8.29,7.86,16
2022,2,06,26,4,25,대전광역시,51351,57157,108508,536112590,618306620,1154419210,10.29,7,17
2022,3,07,03,5,26,대전광역시,44388,68977,113365,444677200,724285590,1168962790,10.86,9.29,20
2022,3,07,10,1,27,대전광역시,22758,110647,133405,237024760,1199123970,1436148730,9.43,10.86,20
2022,3,07,17,2,28,대전광역시,16639,72785,89424,173301920,788125990,961427910,7.57,14.57,22
2022,3,07,24,3,29,대전광역시,40854,69081,109935,431891400,716191848,1148083248,7.71,13.57,21
2022,3,07,31,4,30,대전광역시,109324,45896,155220,1132167869,461395888,1593563757,9,9.29,18
2022,3,08,07,1,31,대전광역시,136574,29809,166383,1413235908,302196119,1715432027,8.57,11.29,20
2022,3,08,14,2,32,대전광역시,118264,17850,136114,1238280575,178924900,1417205475,8.86,12.71,22
2022,3,08,21,3,33,대전광역시,92563,22607,115170,977684804,241340799,1219025603,9.71,13.14,23
2022,3,08,28,4,34,대전광역시,51917,13426,65343,536024995,144075213,680100208,11.29,13.14,24
2022,3,09,04,1,35,대전광역시,47236,8957,56193,463682858,95632657,559315515,10.29,15.57,26
2022,3,09,11,2,36,대전광역시,122681,7574,130255,1294699804,84484493,1379184297,10.43,12.86,23
2022,3,09,18,3,37,대전광역시,93281,5360,98641,979865684,59170290,1039035974,13,14.14,27
2022,3,09,25,4,38,대전광역시,48821,7467,56288,513493160,89258615,602751775,15.57,11.43,27
2022,4,10,02,5,39,대전광역시,44956,8493,53449,439566415,103072177,542638592,13,7.86,21
2022,4,10,09,1,40,대전광역시,40462,14058,54520,402563308,151699303,554262611,17.57,9.86,27
2022,4,10,16,2,41,대전광역시,24626,15281,39907,230896123,159851795,390747918,16.29,17,33
2022,4,10,23,3,42,대전광역시,13208,22276,35484,115425322,229528767,344954089,15.86,15.71,32
2022,4,10,30,4,43,대전광역시,22460,13724,36184,207799584,136243573,344043157,14.29,16.43,31
2022,4,11,06,1,44,대전광역시,17115,8983,26098,166764998,87043462,253808460,15.86,16.43,32
2022,4,11,13,2,45,대전광역시,7443,41589,49032,72010769,446312538,518323307,12.14,15.29,27
2022,4,11,20,3,46,대전광역시,31437,27295,58732,308502307,285519589,594021896,12.29,12.14,24
2022,4,11,27,4,47,대전광역시,45250,13522,58772,439145175,138052231,577197406,11.29,15,26
2022,4,12,04,1,48,대전광역시,58133,12385,70518,561781158,118594459,680375617,13.71,15.86,30
2022,4,12,11,2,49,대전광역시,39771,12207,51978,389991753,121267434,511259187,15.57,19,35
2022,4,12,18,3,50,대전광역시,23528,102473,126001,230064422,1274100057,1504164479,12.14,14,26
2022,4,12,25,4,51,대전광역시,39410,115453,154863,396263434,1482842018,1879105452,9.71,9.57,19
2023,1,01,01,5,52,대전광역시,42137,83995,126132,412368700,1090961691,1503330391,10.14,9.71,20
2022,1,01,09,1,1,부산광역시,30699,63187,93886,301187380,611395090,912582470,9,20.29,29
2022,1,01,16,2,2,부산광역시,32382,46501,78883,324495700,445980820,770476520,6.14,21,27
2022,1,01,23,3,3,부산광역시,22387,40385,62772,223934500,358838700,582773200,7.86,23.29,31
2022,1,01,30,4,4,부산광역시,57953,17036,74989,551252480,145679700,696932180,14,20,34
2022,1,02,06,1,5,부산광역시,70322,16676,86998,697919500,144554500,842474000,12,20.29,32
2022,1,02,13,2,6,부산광역시,19548,21910,41458,189854300,207202200,397056500,10.43,24.57,35
2022,1,02,20,3,7,부산광역시,9365,46453,55818,75342000,444581430,519923430,11.14,24.43,36
2022,1,02,27,4,8,부산광역시,7550,37024,44574,61140760,340052780,401193540,11.57,29.71,41
2022,1,03,06,1,9,부산광역시,3499,46623,50122,26952170,448895550,475847720,9.71,28.14,38
2022,1,03,13,2,10,부산광역시,17767,28084,45851,168818120,266703300,435521420,10.29,25.86,36
2022,1,03,20,3,11,부산광역시,11393,26268,37661,107415900,247656960,355072860,7.14,29.57,37
2022,1,03,27,4,12,부산광역시,30284,16300,46584,292296240,147396260,439692500,6.57,32.43,39
2022,2,04,03,5,13,부산광역시,17370,30670,48040,159933800,278316960,438250760,7.71,31.71,39
2022,2,04,10,1,14,부산광역시,12108,30167,42275,112405660,286420100,398825760,8.86,28.29,37
2022,2,04,17,2,15,부산광역시,6841,43983,50824,62564100,428077160,490641260,9.86,25,35
2022,2,04,24,3,16,부산광역시,17238,30694,47932,178857720,296690000,475547720,14,20.14,34
2022,2,05,01,4,17,부산광역시,41200,31171,72371,387288470,283839980,671128450,16.71,18,35
2022,2,05,08,1,18,부산광역시,16055,253952,270007,159557000,2586294840,2745851840,13.57,21.71,35
2022,2,05,15,2,19,부산광역시,19781,104194,123975,199486520,1073441490,1272928010,10.29,18.43,29
2022,2,05,22,3,20,부산광역시,239505,41540,281045,2470294450,419165860,2889460310,9,18.86,28
2022,2,05,29,4,21,부산광역시,226151,21871,248022,2266696880,213272520,2479969400,12,15.14,27
2022,2,06,05,1,22,부산광역시,167851,146332,314183,1691745160,1461100070,3152845230,11.86,14.29,26
2022,2,06,12,2,23,부산광역시,169637,67983,237620,1715809460,669089400,2384898860,9.57,13.71,23
2022,2,06,19,3,24,부산광역시,187693,27082,214775,1904699650,271899140,2176598790,12.29,14.29,27
2022,2,06,26,4,25,부산광역시,108084,106201,214285,1094125840,1111670290,2205796130,14.71,14,29
2022,3,07,03,5,26,부산광역시,97841,129254,227095,953050060,1322910550,2275960610,15.71,16.29,32
2022,3,07,10,1,27,부산광역시,47624,198263,245887,478571600,2070970490,2549542090,12,15,27
2022,3,07,17,2,28,부산광역시,35708,139799,175507,364504060,1462806040,1827310100,9.14,17.29,26
2022,3,07,24,3,29,부산광역시,86670,125199,211869,901405800,1258499720,2159905520,10.29,20.29,31
2022,3,07,31,4,30,부산광역시,215746,87366,303112,2178265078,855425060,3033690138,11.43,15.57,27
2022,3,08,07,1,31,부산광역시,302914,63227,366141,3032239797,612799232,3645039029,13.14,14.43,28
2022,3,08,14,2,32,부산광역시,239856,34445,274301,2439816980,340171847,2779988827,11.14,16.14,27
2022,3,08,21,3,33,부산광역시,184759,43700,228459,1889555874,450987981,2340543855,14.71,18.29,33
2022,3,08,28,4,34,부산광역시,108174,28748,136922,1085980107,290672264,1376652371,13.71,19.86,34
2022,3,09,04,1,35,부산광역시,99819,18082,117901,949198793,180337890,1129536683,16.57,22.71,39
2022,3,09,11,2,36,부산광역시,231946,15991,247937,2388538598,160764491,2549303089,18.43,22.43,41
2022,3,09,18,3,37,부산광역시,188085,13969,202054,1945824117,124742467,2070566584,20.43,23.14,44
2022,3,09,25,4,38,부산광역시,103940,13308,117248,1041700055,162844753,1204544808,21.43,16.43,38
2022,4,10,02,5,39,부산광역시,100880,17236,118116,978653592,202168594,1180822186,20.14,14,34
2022,4,10,09,1,40,부산광역시,86139,27677,113816,843060531,299126614,1142187145,20.43,14.57,35
2022,4,10,16,2,41,부산광역시,51516,29291,80807,472965804,302850447,775816251,21.86,22.43,44
2022,4,10,23,3,42,부산광역시,30291,44184,74475,262100925,447922612,710023537,20.57,21.57,42
2022,4,10,30,4,43,부산광역시,53175,29721,82896,488296907,280996193,769293100,19.71,26,46
2022,4,11,06,1,44,부산광역시,41936,18804,60740,399718218,183469039,583187257,21.71,23.14,45
2022,4,11,13,2,45,부산광역시,24877,82011,106888,223099215,838905103,1062004318,18.43,21.57,40
2022,4,11,20,3,46,부산광역시,62918,54400,117318,611725423,541639481,1153364904,17.57,19.43,37
2022,4,11,27,4,47,부산광역시,91135,28497,119632,883173963,272570800,1155744763,17,21.29,38
2022,4,12,04,1,48,부산광역시,119592,25230,144822,1150153529,230974080,1381127609,19.43,22.57,42
2022,4,12,11,2,49,부산광역시,85884,27109,112993,830222411,272207706,1102430117,19.71,30.71,50
2022,4,12,18,3,50,부산광역시,44694,197919,242613,425968372,2293670990,2719639362,14,28.14,42
2022,4,12,25,4,51,부산광역시,77145,220949,298094,756450195,2635985977,3392436172,11.14,22.14,33
2023,1,01,01,5,52,부산광역시,95882,172094,267976,907042264,2032069151,2939111415,13.14,22,35
2022,1,01,09,1,1,서울특별시,104421,293510,397931,1047318270,3065935090,4113253360,15,39.86,55
2022,1,01,16,2,2,서울특별시,112776,245654,358430,1083191050,2495114170,3578305220,14.14,40.29,54
2022,1,01,23,3,3,서울특별시,77180,202409,279589,773019900,1946443120,2719463020,14,40.57,55
2022,1,01,30,4,4,서울특별시,202161,104836,306997,1933041890,958265840,2891307730,18.71,40,59
2022,1,02,06,1,5,서울특별시,228986,113556,342542,2308883460,1059933200,3368816660,16.86,40.29,57
2022,1,02,13,2,6,서울특별시,68274,135543,203817,633591700,1396919010,2030510710,17.29,46.57,64
2022,1,02,20,3,7,서울특별시,52723,217244,269967,355317730,2178448000,2533765730,18,46.57,65
2022,1,02,27,4,8,서울특별시,50232,177575,227807,307139010,1725824530,2032963540,18.43,49.71,68
2022,1,03,06,1,9,서울특별시,24635,265311,289946,162479640,2784003360,2946483000,17.29,45.29,63
2022,1,03,13,2,10,서울특별시,66198,153516,219714,636692080,1596986006,2233678086,14.71,45.14,60
2022,1,03,20,3,11,서울특별시,44620,139268,183888,411413350,1375626070,1787039420,14.29,46.71,61
2022,1,03,27,4,12,서울특별시,76916,92287,169203,727021580,890234070,1617255650,16.57,56.86,73
2022,2,04,03,5,13,서울특별시,42789,159708,202497,385362110,1518656330,1904018440,15.29,54.14,69
2022,2,04,10,1,14,서울특별시,33649,130222,163871,286086670,1266397870,1552484540,18.14,53.71,72
2022,2,04,17,2,15,서울특별시,25952,220008,245960,227773610,2293891790,2521665400,20.57,50.86,71
2022,2,04,24,3,16,서울특별시,66808,161786,228594,722622740,1670965830,2393588570,27,50.71,78
2022,2,05,01,4,17,서울특별시,123127,160704,283831,1203103860,1485368110,2688471970,27.14,55.57,83
2022,2,05,08,1,18,서울특별시,44447,1044243,1088690,460849920,11391092050,11851941970,22.43,44,66
2022,2,05,15,2,19,서울특별시,63868,462446,526314,664727950,5217315060,5882043010,24,38,62
2022,2,05,22,3,20,서울특별시,736485,208316,944801,7806936070,2205686500,10012622570,22.14,42.57,65
2022,2,05,29,4,21,서울특별시,735011,114334,849345,7582580250,1167641830,8750222080,25.14,40.14,65
2022,2,06,05,1,22,서울특별시,589886,493795,1083681,6067050850,5293920220,11360971070,22,33.29,55
2022,2,06,12,2,23,서울특별시,605797,252779,858576,6246810230,2687136730,8933946960,19.14,32.86,52
2022,2,06,19,3,24,서울특별시,631201,155103,786304,6557723880,1668696430,8226420310,23.86,34.71,59
2022,2,06,26,4,25,서울특별시,371475,461971,833446,3779635120,5083535930,8863171050,30.71,38.86,70
2022,3,07,03,5,26,서울특별시,367850,543884,911734,3711194500,5959039830,9670234330,24.29,38.71,63
2022,3,07,10,1,27,서울특별시,223133,867570,1090703,2379175120,9756357000,12135532120,23,36.14,59
2022,3,07,17,2,28,서울특별시,186319,598328,784647,1965043760,6666952320,8631996080,22.43,35.57,58
2022,3,07,24,3,29,서울특별시,328059,506466,834525,3612914401,5428304173,9041218574,23.14,35.29,58
2022,3,07,31,4,30,서울특별시,686895,347036,1033931,7369035554,3583080453,10952116007,23.43,29.57,53
2022,3,08,07,1,31,서울특별시,865562,237964,1103526,9133916844,2478987311,11612904155,21.71,29.86,52
2022,3,08,14,2,32,서울특별시,760522,157550,918072,8014499841,1678481223,9692981064,21.71,33.43,55
2022,3,08,21,3,33,서울특별시,605771,231304,837075,6462616312,2608783473,9071399785,22.29,39.57,62
2022,3,08,28,4,34,서울특별시,351896,160429,512325,3633656996,1776884410,5410541406,24,47.86,72
2022,3,09,04,1,35,서울특별시,307100,113132,420232,3049089575,1237373031,4286462606,27.71,47.86,76
2022,3,09,11,2,36,서울특별시,694483,92674,787157,7424114795,1042159822,8466274617,28.29,42.29,71
2022,3,09,18,3,37,서울특별시,553441,74393,627834,5929995592,809568081,6739563673,29.29,45.14,74
2022,3,09,25,4,38,서울특별시,332146,78376,410522,3418967497,1029245117,4448212614,32.57,39,72
2022,4,10,02,5,39,서울특별시,337550,81526,419076,3353748304,1087750455,4441498759,30.71,40.71,71
2022,4,10,09,1,40,서울특별시,298068,112142,410210,3014646347,1347679621,4362325968,37,44,81
2022,4,10,16,2,41,서울특별시,203606,152565,356171,1906391638,1665609497,3572001135,37.57,45.57,83
2022,4,10,23,3,42,서울특별시,114234,211519,325753,1007975907,2269830077,3277805984,36.14,47.14,83
2022,4,10,30,4,43,서울특별시,169736,149163,318899,1618089365,1549245867,3167335232,34.43,51.57,86
2022,4,11,06,1,44,서울특별시,140246,108731,248977,1376207265,1131232789,2507440054,38,45,83
2022,4,11,13,2,45,서울특별시,76829,349258,426087,741640409,3877158320,4618798729,32,41.43,73
2022,4,11,20,3,46,서울특별시,206405,237236,443641,2106966626,2613089854,4720056480,29.71,35,65
2022,4,11,27,4,47,서울특별시,324723,146035,470758,3271525750,1493053778,4764579528,30.86,42.14,73
2022,4,12,04,1,48,서울특별시,440046,118756,558802,4460623801,1161605838,5622229639,31,48.86,80
2022,4,12,11,2,49,서울특별시,312251,124822,437073,3115123993,1367401195,4482525188,32.43,52.57,85
2022,4,12,18,3,50,서울특별시,170246,708562,878808,1656479783,8801090922,10457570705,29,48.43,77
2022,4,12,25,4,51,서울특별시,286265,761301,1047566,2928618241,9720321118,12648939359,24.57,41.29,66
2023,1,01,01,5,52,서울특별시,325406,606971,932377,3183709689,7683381564,10867091253,24.57,37,62
2022,1,01,09,1,1,세종특별자치시,2059,6353,8412,20921140,62865870,83787010,1.71,3.29,5
2022,1,01,16,2,2,세종특별자치시,1853,4720,6573,18597740,46042530,64640270,2,5.14,7
2022,1,01,23,3,3,세종특별자치시,1245,3933,5178,12574510,35895330,48469840,2,7.86,10
2022,1,01,30,4,4,세종특별자치시,4897,1704,6601,46307870,15128740,61436610,4,4.14,8
2022,1,02,06,1,5,세종특별자치시,5851,1701,7552,58988340,15806120,74794460,4.14,2.86,7
2022,1,02,13,2,6,세종특별자치시,1330,1505,2835,13159230,14459240,27618470,3.86,4.71,9
2022,1,02,20,3,7,세종특별자치시,688,3562,4250,5527980,34711900,40239880,4,6.14,10
2022,1,02,27,4,8,세종특별자치시,696,2819,3515,5701650,27002230,32703880,4.14,9.71,14
2022,1,03,06,1,9,세종특별자치시,238,4120,4358,1998040,41341470,43339510,2.57,6.86,9
2022,1,03,13,2,10,세종특별자치시,1846,2355,4201,18052080,23676040,41728120,2.71,6.43,9
2022,1,03,20,3,11,세종특별자치시,1040,1756,2796,10097950,17391900,27489850,1.71,5.43,7
2022,1,03,27,4,12,세종특별자치시,1406,1109,2515,13781290,10762930,24544220,1.86,6.43,8
2022,2,04,03,5,13,세종특별자치시,742,2227,2969,7026530,21143920,28170450,2.71,7.29,10
2022,2,04,10,1,14,세종특별자치시,542,2148,2690,4869100,21466770,26335870,3,5.43,8
2022,2,04,17,2,15,세종특별자치시,458,3914,4372,3182000,40497980,43679980,2.71,5.57,8
2022,2,04,24,3,16,세종특별자치시,1048,2663,3711,11087890,27351450,38439340,2.57,6.43,9
2022,2,05,01,4,17,세종특별자치시,2657,3468,6125,25492050,33654150,59146200,5.14,7.57,13
2022,2,05,08,1,18,세종특별자치시,774,27638,28412,8315080,290454300,298769380,3.14,6,9
2022,2,05,15,2,19,세종특별자치시,1442,10584,12026,15522020,107545740,123067760,2.86,6.29,9
2022,2,05,22,3,20,세종특별자치시,19714,4507,24221,210213580,44983650,255197230,2.57,3.71,6
2022,2,05,29,4,21,세종특별자치시,19193,2097,21290,198143120,21501690,219644810,3.43,2.14,6
2022,2,06,05,1,22,세종특별자치시,14477,17133,31610,153410150,175673830,329083980,2.14,2.86,5
2022,2,06,12,2,23,세종특별자치시,14024,8437,22461,150924350,85062870,235987220,1.71,2.29,4
2022,2,06,19,3,24,세종특별자치시,15797,3953,19750,167421270,38921130,206342400,2.71,3,6
2022,2,06,26,4,25,세종특별자치시,8118,10675,18793,85501320,112215310,197716630,4.29,2.86,7
2022,3,07,03,5,26,세종특별자치시,8470,13543,22013,86769600,138299400,225069000,4.29,3.43,8
2022,3,07,10,1,27,세종특별자치시,4001,21605,25606,43937050,231597220,275534270,3.29,3.86,7
2022,3,07,17,2,28,세종특별자치시,2831,13430,16261,30521640,144905210,175426850,4.14,5,9
2022,3,07,24,3,29,세종특별자치시,7216,15857,23073,76982660,163367640,240350300,2.71,4.43,7
2022,3,07,31,4,30,세종특별자치시,21961,10761,32722,224844010,107197800,332041810,3,3.57,7
2022,3,08,07,1,31,세종특별자치시,27127,6735,33862,284702369,69079430,353781799,4.29,3,7
2022,3,08,14,2,32,세종특별자치시,20277,3734,24011,212361087,37813000,250174087,3.86,3.57,7
2022,3,08,21,3,33,세종특별자치시,17681,4642,22323,188409177,49031240,237440417,4.57,4.29,9
2022,3,08,28,4,34,세종특별자치시,8913,1860,10773,91009029,19534799,110543828,3.71,5.29,9
2022,3,09,04,1,35,세종특별자치시,7750,852,8602,75338058,8835140,84173198,4.43,5.14,10
2022,3,09,11,2,36,세종특별자치시,20455,591,21046,216746975,6065200,222812175,6.14,2.43,9
2022,3,09,18,3,37,세종특별자치시,15832,282,16114,167462964,2957200,170420164,6.57,2.71,9
2022,3,09,25,4,38,세종특별자치시,7180,705,7885,74117625,8583299,82700924,7.14,2.29,9
2022,4,10,02,5,39,세종특별자치시,7900,1055,8955,78770336,10845080,89615416,6,1.29,7
2022,4,10,09,1,40,세종특별자치시,7633,2155,9788,76351209,22201776,98552985,7.86,2.43,10
2022,4,10,16,2,41,세종특별자치시,5033,2374,7407,47963387,24509928,72473315,6.71,4.86,12
2022,4,10,23,3,42,세종특별자치시,2544,4245,6789,21802814,43631317,65434131,6.86,5.14,12
2022,4,10,30,4,43,세종특별자치시,3718,2827,6545,35077878,26216480,61294358,5.43,6.43,12
2022,4,11,06,1,44,세종특별자치시,2475,1780,4255,24583665,18075473,42659138,4.86,7.43,12
2022,4,11,13,2,45,세종특별자치시,1149,8659,9808,10724695,86817880,97542575,3.57,5.43,9
2022,4,11,20,3,46,세종특별자치시,6402,5695,12097,62382876,55715645,118098521,4.14,5,9
2022,4,11,27,4,47,세종특별자치시,7678,2734,10412,77381814,26138748,103520562,4.29,4.57,9
2022,4,12,04,1,48,세종특별자치시,8984,1862,10846,91474384,16618651,108093035,6.86,5.43,12
2022,4,12,11,2,49,세종특별자치시,6960,2066,9026,68543304,20855507,89398811,6.43,8.14,15
2022,4,12,18,3,50,세종특별자치시,3441,21169,24610,33117002,243868803,276985805,4,3.43,7
2022,4,12,25,4,51,세종특별자치시,8311,21386,29697,82461799,250710638,333172437,3.86,2.43,6
2023,1,01,01,5,52,세종특별자치시,7521,16695,24216,75511243,196815973,272327216,4.14,3.71,8
2022,1,01,09,1,1,울산광역시,9700,18252,27952,92280480,181180560,273461040,3.43,7.43,11
2022,1,01,16,2,2,울산광역시,11562,14310,25872,114672200,136971000,251643200,3.57,8.57,12
2022,1,01,23,3,3,울산광역시,8212,11827,20039,79570170,108598300,188168470,3.71,13.57,17
2022,1,01,30,4,4,울산광역시,20542,4754,25296,191078420,41688370,232766790,5.29,10.29,16
2022,1,02,06,1,5,울산광역시,23295,4496,27791,226721900,39815900,266537800,6.71,6.57,13
2022,1,02,13,2,6,울산광역시,5561,6188,11749,52131300,62558100,114689400,4.29,10.57,15
2022,1,02,20,3,7,울산광역시,2686,13283,15969,20740000,130789200,151529200,5.71,10.57,16
2022,1,02,27,4,8,울산광역시,2302,9974,12276,18472500,93193170,111665670,7.43,15.71,23
2022,1,03,06,1,9,울산광역시,1232,12749,13981,10425300,128685500,139110800,5.86,13.86,20
2022,1,03,13,2,10,울산광역시,4990,7132,12122,46193800,70776000,116969800,3.57,11,15
2022,1,03,20,3,11,울산광역시,3257,6452,9709,29439400,63946000,93385400,2.43,11,13
2022,1,03,27,4,12,울산광역시,7644,4120,11764,72112600,38709860,110822460,2.14,12.57,15
2022,2,04,03,5,13,울산광역시,3831,7701,11532,35236900,74139600,109376500,3.29,14.71,18
2022,2,04,10,1,14,울산광역시,3133,7618,10751,29129900,75582800,104712700,4.57,14.14,19
2022,2,04,17,2,15,울산광역시,2260,11989,14249,20226800,125990100,146216900,4.29,10.71,15
2022,2,04,24,3,16,울산광역시,4508,8986,13494,47994240,89510860,137505100,6.43,10.57,17
2022,2,05,01,4,17,울산광역시,10490,8399,18889,97656500,76783720,174440220,9.14,13.43,23
2022,2,05,08,1,18,울산광역시,4333,77988,82321,43363700,838997220,882360920,5,10.43,15
2022,2,05,15,2,19,울산광역시,6111,31074,37185,63408100,340221700,403629800,4.29,10.14,14
2022,2,05,22,3,20,울산광역시,70590,12440,83030,742322120,128322620,870644740,4.71,7,12
2022,2,05,29,4,21,울산광역시,67986,6274,74260,691372630,65226100,756598730,6.86,5.14,12
2022,2,06,05,1,22,울산광역시,55434,53519,108953,555770400,544298560,1100068960,4.43,6,10
2022,2,06,12,2,23,울산광역시,53201,25443,78644,532900200,250234200,783134400,4.29,4,8
2022,2,06,19,3,24,울산광역시,57585,9218,66803,584604960,95220460,679825420,3.86,4.57,8
2022,2,06,26,4,25,울산광역시,32993,33483,66476,336704260,375915460,712619720,4.29,4.43,9
2022,3,07,03,5,26,울산광역시,24230,36809,61039,241721700,409038700,650760400,6,5.71,12
2022,3,07,10,1,27,울산광역시,13769,60045,73814,141752420,651055990,792808410,4.43,6.29,11
2022,3,07,17,2,28,울산광역시,10328,43578,53906,107194000,460396240,567590240,5,9.43,14
2022,3,07,24,3,29,울산광역시,24866,39955,64821,259564860,404069520,663634380,5,8.57,14
2022,3,07,31,4,30,울산광역시,68845,27059,95904,700901140,265100200,966001340,4.71,4.86,10
2022,3,08,07,1,31,울산광역시,113313,24638,137951,1134473596,242679900,1377153496,5,4.14,9
2022,3,08,14,2,32,울산광역시,77702,11471,89173,781171316,115788199,896959515,6,6.14,12
2022,3,08,21,3,33,울산광역시,58131,14807,72938,583497291,155511091,739008382,7.14,9.86,17
2022,3,08,28,4,34,울산광역시,34913,8159,43072,345690952,86874294,432565246,6.86,9.71,17
2022,3,09,04,1,35,울산광역시,31204,5029,36233,295138490,56259898,351398388,8,9.57,18
2022,3,09,11,2,36,울산광역시,76151,4210,80361,778750971,49070195,827821166,8.71,6.86,16
2022,3,09,18,3,37,울산광역시,60304,3523,63827,607112742,38482897,645595639,9.57,7.71,17
2022,3,09,25,4,38,울산광역시,32837,4248,37085,321531442,63698597,385230039,10,6.43,16
2022,4,10,02,5,39,울산광역시,31287,6444,37731,296881140,81917588,378798728,7.14,5.71,13
2022,4,10,09,1,40,울산광역시,28392,8730,37122,273352196,96844080,370196276,10.29,7.57,18
2022,4,10,16,2,41,울산광역시,17406,8744,26150,155826069,92360461,248186530,10.57,11.29,22
2022,4,10,23,3,42,울산광역시,10253,14328,24581,87886972,145838011,233724983,11.71,11.71,23
2022,4,10,30,4,43,울산광역시,16813,8259,25072,154897655,82930466,237828121,11.29,13,24
2022,4,11,06,1,44,울산광역시,12855,4765,17620,119550419,46100675,165651094,11.43,12,23
2022,4,11,13,2,45,울산광역시,5227,23771,28998,50340978,254703968,305044946,9.29,10.14,19
2022,4,11,20,3,46,울산광역시,19219,15557,34776,186144819,163304143,349448962,8.29,9,17
2022,4,11,27,4,47,울산광역시,28621,8526,37147,277719878,85295979,363015857,8.43,9.71,18
2022,4,12,04,1,48,울산광역시,38448,7095,45543,361919154,72874331,434793485,9.29,10.57,20
2022,4,12,11,2,49,울산광역시,26444,7463,33907,250475709,76479647,326955356,9.57,15,25
2022,4,12,18,3,50,울산광역시,16393,59892,76285,152674865,753867699,906542564,7.29,6.86,14
2022,4,12,25,4,51,울산광역시,26129,73747,99876,252156648,930791183,1182947831,5.86,4.86,11
2023,1,01,01,5,52,울산광역시,27996,55592,83588,269550748,731881064,1001431812,6.43,5.71,12
2022,1,01,09,1,1,인천광역시,21409,48586,69995,214850400,492212750,707063150,5.14,12.71,18
2022,1,01,16,2,2,인천광역시,24041,35734,59775,251618170,352371390,603989560,6.29,14.43,21
2022,1,01,23,3,3,인천광역시,14800,28855,43655,151105300,271500250,422605550,7.14,19.86,27
2022,1,01,30,4,4,인천광역시,42058,12762,54820,408999810,111796970,520796780,10.43,13.71,24
2022,1,02,06,1,5,인천광역시,54337,13372,67709,557159390,120070460,677229850,12.71,15.71,28
2022,1,02,13,2,6,인천광역시,13063,14642,27705,130430700,141110060,271540760,9,25.57,35
2022,1,02,20,3,7,인천광역시,5730,33720,39450,46089570,335621220,381710790,8.29,23.57,32
2022,1,02,27,4,8,인천광역시,5122,27046,32168,41207570,261938810,303146380,9.14,28.29,37
2022,1,03,06,1,9,인천광역시,2819,37473,40292,22076240,381052490,403128730,9,27.57,37
2022,1,03,13,2,10,인천광역시,12195,22406,34601,123421590,219974860,343396450,7.57,25.14,33
2022,1,03,20,3,11,인천광역시,6715,17815,24530,64969820,178393360,243363180,7.71,24.43,32
2022,1,03,27,4,12,인천광역시,15220,11733,26953,151746270,110658670,262404940,7.71,28.29,36
2022,2,04,03,5,13,인천광역시,8178,24343,32521,78114160,233179810,311293970,8.86,28,37
2022,2,04,10,1,14,인천광역시,5965,21862,27827,55769000,214904480,270673480,8.71,30,39
2022,2,04,17,2,15,인천광역시,3433,32818,36251,31314000,342401780,373715780,8.43,26.71,35
2022,2,04,24,3,16,인천광역시,10245,24910,35155,112295000,253507960,365802960,10.86,23.43,34
2022,2,05,01,4,17,인천광역시,23905,23725,47630,233064670,221917940,454982610,15.71,23.57,39
2022,2,05,08,1,18,인천광역시,11370,212489,223859,114721380,2279644650,2394366030,12.29,18.57,31
2022,2,05,15,2,19,인천광역시,15018,80968,95986,162981060,864367840,1027348900,11.14,18.71,30
2022,2,05,22,3,20,인천광역시,196920,33454,230374,2133932330,345037350,2478969680,10.43,23.29,34
2022,2,05,29,4,21,인천광역시,177934,17609,195543,1857392340,175722880,2033115220,12,19.86,32
2022,2,06,05,1,22,인천광역시,134525,116226,250751,1423190390,1209100380,2632290770,11.43,16.57,28
2022,2,06,12,2,23,인천광역시,133615,55753,189368,1402003400,571161440,1973164840,11.43,15,26
2022,2,06,19,3,24,인천광역시,153659,25179,178838,1626054310,254440860,1880495170,10.71,17.29,28
2022,2,06,26,4,25,인천광역시,80181,75773,155954,845587900,819881890,1665469790,14,17.29,31
2022,3,07,03,5,26,인천광역시,64236,86458,150694,655981840,905811480,1561793320,15,19.43,34
2022,3,07,10,1,27,인천광역시,34615,157646,192261,363383460,1695511870,2058895330,11.14,18.57,30
2022,3,07,17,2,28,인천광역시,25934,108696,134630,274557940,1145771000,1420328940,11,20.57,32
2022,3,07,24,3,29,인천광역시,62697,99547,162244,665845760,1017413958,1683259718,9.29,19.57,29
2022,3,07,31,4,30,인천광역시,151236,66980,218216,1578490203,663232036,2241722239,10.29,17.86,28
2022,3,08,07,1,31,인천광역시,210945,48802,259747,2180455945,478995411,2659451356,11.57,16.14,28
2022,3,08,14,2,32,인천광역시,166567,25794,192361,1751372239,259297607,2010669846,12.71,17,30
2022,3,08,21,3,33,인천광역시,133226,33378,166604,1403996660,352803139,1756799799,13.57,21.43,35
2022,3,08,28,4,34,인천광역시,76687,20018,96705,789985450,208970986,998956436,13.71,21.29,35
2022,3,09,04,1,35,인천광역시,66931,11565,78496,668159673,117899247,786058920,14.57,22.86,37
2022,3,09,11,2,36,인천광역시,185386,10418,195804,1972134513,114937103,2087071616,16.14,19.57,36
2022,3,09,18,3,37,인천광역시,141373,7693,149066,1487921621,81897196,1569818817,17.86,19.57,37
2022,3,09,25,4,38,인천광역시,72485,8367,80852,754759601,112162200,866921801,18.57,17.29,36
2022,4,10,02,5,39,인천광역시,76122,14993,91115,752953006,175598649,928551655,19,16.29,35
2022,4,10,09,1,40,인천광역시,70905,20901,91806,709624515,231112603,940737118,21.14,16.71,38
2022,4,10,16,2,41,인천광역시,44771,22614,67385,414028624,240032056,654060680,21.57,22.43,44
2022,4,10,23,3,42,인천광역시,25047,37084,62131,215954853,384221548,600176401,22,21,43
2022,4,10,30,4,43,인천광역시,34212,20753,54965,323866897,206064445,529931342,20.86,20.14,41
2022,4,11,06,1,44,인천광역시,26631,13621,40252,262711226,138461229,401172455,22.43,21.14,44
2022,4,11,13,2,45,인천광역시,11473,62951,74424,113389691,666218497,779608188,15.14,16.29,31
2022,4,11,20,3,46,인천광역시,46026,39868,85894,462824214,410137727,872961941,14.86,15.71,31
2022,4,11,27,4,47,인천광역시,65618,19630,85248,668479665,196575696,865055361,13.57,18.86,32
2022,4,12,04,1,48,인천광역시,87874,18007,105881,863514526,176524202,1040038728,17.43,18.57,36
2022,4,12,11,2,49,인천광역시,65392,17287,82679,646424542,175873138,822297680,20,23.71,44
2022,4,12,18,3,50,인천광역시,34244,150532,184776,338393803,1797342875,2135736678,14.43,20.43,35
2022,4,12,25,4,51,인천광역시,67166,162035,229201,680743069,1966264916,2647007985,12.29,17.43,30
2023,1,01,01,5,52,인천광역시,70732,118896,189628,699355888,1448680160,2148036048,10.71,18.71,29
2022,1,01,09,1,1,전라남도,9752,15765,25517,88140300,145813440,233953740,1.86,6.43,8
2022,1,01,16,2,2,전라남도,10184,10661,20845,91978380,94873940,186852320,3,6.57,10
2022,1,01,23,3,3,전라남도,6825,8020,14845,61264240,68587740,129851980,3.29,10.43,14
2022,1,01,30,4,4,전라남도,19545,3285,22830,171274480,28523460,199797940,6.43,5.14,12
2022,1,02,06,1,5,전라남도,23145,3016,26161,213385940,27028800,240414740,5.86,3,9
2022,1,02,13,2,6,전라남도,6115,3678,9793,54909680,33531190,88440870,5.43,6.71,12
2022,1,02,20,3,7,전라남도,3369,11520,14889,25778000,104312780,130090780,5.57,9.29,15
2022,1,02,27,4,8,전라남도,2623,8701,11324,21020400,76129620,97150020,6.43,12.57,19
2022,1,03,06,1,9,전라남도,1105,9797,10902,8454100,91710520,100164620,6.57,10.57,17
2022,1,03,13,2,10,전라남도,4724,6262,10986,42460280,57985120,100445400,5.14,8.71,14
2022,1,03,20,3,11,전라남도,3081,4817,7898,27707680,44725500,72433180,3.71,10.29,14
2022,1,03,27,4,12,전라남도,6225,3442,9667,56486200,30280900,86767100,3.43,11.43,15
2022,2,04,03,5,13,전라남도,3313,6605,9918,29686560,57511680,87198240,4.86,9.14,14
2022,2,04,10,1,14,전라남도,2576,6942,9518,24182460,64141160,88323620,5.29,8.43,14
2022,2,04,17,2,15,전라남도,1317,10072,11389,11625540,98602740,110228280,6,7,13
2022,2,04,24,3,16,전라남도,4311,7319,11630,41259570,71178800,112438370,6.29,7.57,14
2022,2,05,01,4,17,전라남도,10369,7376,17745,88696500,66069160,154765660,7.29,9.14,16
2022,2,05,08,1,18,전라남도,6054,72485,78539,54561260,703139840,757701100,6.14,7.71,14
2022,2,05,15,2,19,전라남도,6693,29460,36153,67166660,278836820,346003480,6.14,8.43,15
2022,2,05,22,3,20,전라남도,79258,12578,91836,790743240,117380020,908123260,5.86,7.14,13
2022,2,05,29,4,21,전라남도,73719,6662,80381,702779480,58959700,761739180,8.86,4.43,13
2022,2,06,05,1,22,전라남도,54983,57965,112948,546234540,538821360,1085055900,5.57,6,12
2022,2,06,12,2,23,전라남도,54742,25055,79797,534325370,228458120,762783490,4.14,5.86,10
2022,2,06,19,3,24,전라남도,67368,8765,76133,671946020,82088480,754034500,4,6.29,10
2022,2,06,26,4,25,전라남도,38975,31004,69979,392154260,298705020,690859280,5.86,4.43,10
2022,3,07,03,5,26,전라남도,28688,34543,63231,274316600,327526440,601843040,6.29,6.29,13
2022,3,07,10,1,27,전라남도,16544,62085,78629,160613180,596375100,756988280,5.29,5.86,11
2022,3,07,17,2,28,전라남도,11305,42498,53803,111690180,405218960,516909140,6.57,7.29,14
2022,3,07,24,3,29,전라남도,28967,40750,69717,278789958,378912351,657702309,8.14,7.29,15
2022,3,07,31,4,30,전라남도,85798,28660,114458,800194851,265550170,1065745021,6.29,4.57,11
2022,3,08,07,1,31,전라남도,110272,21075,131347,1024470505,201220169,1225690674,6.43,5,11
2022,3,08,14,2,32,전라남도,91503,11386,102889,851198513,110239959,961438472,5.71,7,13
2022,3,08,21,3,33,전라남도,73596,12510,86106,694276267,120556726,814832993,5.57,6.14,12
2022,3,08,28,4,34,전라남도,40454,5553,46007,373236099,55946995,429183094,7.29,7.71,15
2022,3,09,04,1,35,전라남도,34458,2736,37194,307895504,26760296,334655800,6,8.43,14
2022,3,09,11,2,36,전라남도,94116,1792,95908,916772310,16003672,932775982,8.86,3.71,13
2022,3,09,18,3,37,전라남도,74593,1694,76287,703056094,15256497,718312591,9,6,15
2022,3,09,25,4,38,전라남도,35338,2767,38105,332440496,31405900,363846396,10.57,4.57,15
2022,4,10,02,5,39,전라남도,35527,5894,41421,319724239,54788488,374512727,8.43,3,11
2022,4,10,09,1,40,전라남도,33113,8569,41682,298475013,79477924,377952937,10.71,4,15
2022,4,10,16,2,41,전라남도,21341,9467,30808,178860129,88219654,267079783,11.29,6,17
2022,4,10,23,3,42,전라남도,11266,13952,25218,93101254,126651898,219753152,12.29,7.43,20
2022,4,10,30,4,43,전라남도,15732,8854,24586,134621470,77819265,212440735,8.71,7.71,16
2022,4,11,06,1,44,전라남도,12949,5358,18307,114133945,49062555,163196500,8.43,10,18
2022,4,11,13,2,45,전라남도,5838,25427,31265,51120454,253021877,304142331,8,8.71,17
2022,4,11,20,3,46,전라남도,22239,16731,38970,202079649,160355815,362435464,8.43,6.86,15
2022,4,11,27,4,47,전라남도,30742,6912,37654,283822931,63314471,347137402,6.86,6.29,13
2022,4,12,04,1,48,전라남도,38540,5923,44463,343687468,51169984,394857452,10.29,7.43,18
2022,4,12,11,2,49,전라남도,32007,8990,40997,284753670,79521314,364274984,9.86,9.57,19
2022,4,12,18,3,50,전라남도,18112,68678,86790,157582892,750473752,908056644,7.14,7.14,14
2022,4,12,25,4,51,전라남도,33655,70061,103716,303498224,786587236,1090085460,7.43,4,11
2023,1,01,01,5,52,전라남도,35818,51121,86939,320549848,573349205,893899053,8,6.14,14
2022,1,01,09,1,1,전라북도,13996,27567,41563,130789780,257953720,388743500,3.71,21.71,25
2022,1,01,16,2,2,전라북도,14996,19191,34187,142213660,177351490,319565150,5,18.57,24
2022,1,01,23,3,3,전라북도,9313,14968,24281,87221800,132097120,219318920,4.14,19.71,24
2022,1,01,30,4,4,전라북도,29397,6339,35736,268377320,54861980,323239300,7.29,17.29,25
2022,1,02,06,1,5,전라북도,35538,5608,41146,340121280,48989120,389110400,7.71,9.57,17
2022,1,02,13,2,6,전라북도,9203,7571,16774,84661410,71428340,156089750,5.86,13.57,19
2022,1,02,20,3,7,전라북도,4397,18324,22721,33673560,172918320,206591880,8.14,14,22
2022,1,02,27,4,8,전라북도,4575,14490,19065,33455800,131879360,165335160,10.14,17.71,28
2022,1,03,06,1,9,전라북도,1472,18205,19677,12017000,175387700,187404700,10.71,15.57,26
2022,1,03,13,2,10,전라북도,7297,10555,17852,66434180,99729080,166163260,8,14.43,22
2022,1,03,20,3,11,전라북도,4670,8411,13081,41854800,79823960,121678760,6.71,15.86,23
2022,1,03,27,4,12,전라북도,8909,5157,14066,82875060,46595600,129470660,4.43,16.57,21
2022,2,04,03,5,13,전라북도,4495,11231,15726,40968320,101493500,142461820,5,18.86,24
2022,2,04,10,1,14,전라북도,3046,10441,13487,28210900,95788900,123999800,5,18.29,23
2022,2,04,17,2,15,전라북도,1396,18230,19626,11970500,175939860,187910360,6.86,16.86,24
2022,2,04,24,3,16,전라북도,5919,11716,17635,61849900,112356180,174206080,8.43,17,25
2022,2,05,01,4,17,전라북도,13431,11656,25087,124218470,103320410,227538880,9.57,16,26
2022,2,05,08,1,18,전라북도,5407,112803,118210,50422900,1121983560,1172406460,6.29,14,20
2022,2,05,15,2,19,전라북도,8339,44152,52491,85855500,448529300,534384800,6.29,16.86,23
2022,2,05,22,3,20,전라북도,110289,18450,128739,1114146530,177155920,1291302450,6.71,16.14,23
2022,2,05,29,4,21,전라북도,94821,8819,103640,934834080,85102300,1019936380,8.57,14.14,23
2022,2,06,05,1,22,전라북도,72520,76362,148882,723407070,744952720,1468359790,7.29,12.86,20
2022,2,06,12,2,23,전라북도,68519,33714,102233,680010140,323314140,1003324280,5.86,11.29,17
2022,2,06,19,3,24,전라북도,87739,12733,100472,870053380,123082700,993136080,6.14,12,18
2022,2,06,26,4,25,전라북도,48219,43315,91534,477144160,455628190,932772350,9.14,10.57,20
2022,3,07,03,5,26,전라북도,36981,49435,86416,356823660,505661060,862484720,9.86,11.71,22
2022,3,07,10,1,27,전라북도,18689,85890,104579,185718740,879789760,1065508500,7.71,10.86,19
2022,3,07,17,2,28,전라북도,13986,58096,72082,139131100,585447700,724578800,8.57,14,23
2022,3,07,24,3,29,전라북도,37064,55195,92259,374215200,537861149,912076349,8.29,14.86,23
2022,3,07,31,4,30,전라북도,100890,38186,139076,997877938,352892217,1350770155,6.57,11.86,18
2022,3,08,07,1,31,전라북도,132179,24463,156642,1298856527,228389600,1527246127,6.14,11.43,18
2022,3,08,14,2,32,전라북도,107448,14698,122146,1069444474,137351040,1206795514,7,14.29,21
2022,3,08,21,3,33,전라북도,83633,18630,102263,833308366,184238619,1017546985,7.14,14.14,21
2022,3,08,28,4,34,전라북도,47355,9141,56496,466851172,90910819,557761991,8.29,13,21
2022,3,09,04,1,35,전라북도,42085,4442,46527,394041909,45261200,439303109,8,15.57,24
2022,3,09,11,2,36,전라북도,117786,4958,122744,1175959451,53640600,1229600051,10.29,10.29,21
2022,3,09,18,3,37,전라북도,89047,4002,93049,883423624,41456799,924880423,12,9.14,21
2022,3,09,25,4,38,전라북도,44516,4803,49319,430758374,66631100,497389474,13.57,11,25
2022,4,10,02,5,39,전라북도,42356,7158,49514,390506662,80206556,470713218,12.43,8.29,21
2022,4,10,09,1,40,전라북도,40390,12010,52400,379542924,123055272,502598196,15,9,24
2022,4,10,16,2,41,전라북도,25747,12562,38309,231868546,125393790,357262336,13.71,14.86,29
2022,4,10,23,3,42,전라북도,12307,19405,31712,103940996,193898052,297839048,15.14,14,29
2022,4,10,30,4,43,전라북도,21251,12111,33362,192892874,112270785,305163659,13.14,13.14,26
2022,4,11,06,1,44,전라북도,16431,7655,24086,152374578,71522888,223897466,14.86,14.14,29
2022,4,11,13,2,45,전라북도,7108,35929,43037,66863586,357987080,424850666,10.43,15.14,26
2022,4,11,20,3,46,전라북도,26329,20870,47199,251479624,206780385,458260009,10.14,12.71,23
2022,4,11,27,4,47,전라북도,37805,10582,48387,361908657,99275892,461184549,10.14,11.57,22
2022,4,12,04,1,48,전라북도,53042,8882,61924,497830650,81751080,579581730,12.29,13,25
2022,4,12,11,2,49,전라북도,40835,14507,55342,388406613,129327250,517733863,11,18,29
2022,4,12,18,3,50,전라북도,20888,85163,106051,192517314,985197374,1177714688,8.29,15.57,24
2022,4,12,25,4,51,전라북도,35877,91310,127187,340311903,1089208080,1429519983,7,11,18
2023,1,01,01,5,52,전라북도,40398,70997,111395,375288121,849005738,1224293859,9.71,10.29,20
2022,1,01,09,1,1,제주특별자치도,4695,12728,17423,45308200,119089000,164397200,1.86,3.43,5
2022,1,01,16,2,2,제주특별자치도,5187,9185,14372,52697500,85856000,138553500,2.86,7,10
2022,1,01,23,3,3,제주특별자치도,3617,7317,10934,36028000,64452900,100480900,3.14,9.86,13
2022,1,01,30,4,4,제주특별자치도,10770,3235,14005,98331300,28104400,126435700,4.57,4.14,9
2022,1,02,06,1,5,제주특별자치도,12383,3157,15540,120594200,28395200,148989400,4.29,3,7
2022,1,02,13,2,6,제주특별자치도,3442,2645,6087,32172600,24554900,56727500,3.71,6.71,10
2022,1,02,20,3,7,제주특별자치도,1542,6615,8157,11670500,61979900,73650400,4,7,11
2022,1,02,27,4,8,제주특별자치도,1002,5379,6381,7897700,48688600,56586300,4.29,11.57,16
2022,1,03,06,1,9,제주특별자치도,574,6770,7344,4568000,65148400,69716400,4.14,10.71,15
2022,1,03,13,2,10,제주특별자치도,2675,4066,6741,25427000,38927900,64354900,1.86,8.71,11
2022,1,03,20,3,11,제주특별자치도,1617,3316,4933,14633200,31996200,46629400,1.29,9.57,11
2022,1,03,27,4,12,제주특별자치도,3439,2096,5535,32710100,19707100,52417200,1.86,8.57,10
2022,2,04,03,5,13,제주특별자치도,1800,3851,5651,16660100,35464800,52124900,3.14,8.43,12
2022,2,04,10,1,14,제주특별자치도,1240,4297,5537,11980100,40124200,52104300,3.43,7.29,11
2022,2,04,17,2,15,제주특별자치도,656,7262,7918,6163100,70421400,76584500,4.71,6.57,11
2022,2,04,24,3,16,제주특별자치도,2053,5187,7240,22818400,49781800,72600200,4.43,6.29,11
2022,2,05,01,4,17,제주특별자치도,4870,4933,9803,46684900,45505500,92190400,6.29,7.29,14
2022,2,05,08,1,18,제주특별자치도,2511,44209,46720,25515900,436078700,461594600,4.57,6.43,11
2022,2,05,15,2,19,제주특별자치도,3564,18290,21854,37384700,182301000,219685700,3.57,6.29,10
2022,2,05,22,3,20,제주특별자치도,37660,7832,45492,388029400,77472200,465501600,3.86,5.57,9
2022,2,05,29,4,21,제주특별자치도,38030,3882,41912,377788000,38431200,416219200,4,3.43,7
2022,2,06,05,1,22,제주특별자치도,28239,29718,57957,290303600,292095200,582398800,4,3.43,7
2022,2,06,12,2,23,제주특별자치도,30632,13371,44003,309626300,129442100,439068400,3.14,2.86,6
2022,2,06,19,3,24,제주특별자치도,33193,5673,38866,335337100,54391100,389728200,2.86,2.71,6
2022,2,06,26,4,25,제주특별자치도,19807,17023,36830,201516300,172491000,374007300,3.43,3.14,7
2022,3,07,03,5,26,제주특별자치도,13463,17718,31181,132999700,171882800,304882500,4,3.86,8
2022,3,07,10,1,27,제주특별자치도,6848,33069,39917,68395700,328070250,396465950,3.57,3.71,7
2022,3,07,17,2,28,제주특별자치도,5814,25758,31572,59197200,252731300,311928500,3.57,5,9
2022,3,07,24,3,29,제주특별자치도,14362,24311,38673,144244000,237875800,382119800,2.57,4.29,7
2022,3,07,31,4,30,제주특별자치도,39535,18755,58290,387449400,175821600,563271000,4,3.29,7
2022,3,08,07,1,31,제주특별자치도,47356,11060,58416,460781500,102384600,563166100,5.71,3.71,9
2022,3,08,14,2,32,제주특별자치도,42610,8220,50830,421329600,75966000,497295600,5.86,4.71,11
2022,3,08,21,3,33,제주특별자치도,33438,9286,42724,334824600,92334800,427159400,4.57,5.29,10
2022,3,08,28,4,34,제주특별자치도,19905,3927,23832,195686400,40327600,236014000,5.29,6,11
2022,3,09,04,1,35,제주특별자치도,17788,2151,19939,169815600,21662100,191477700,6.43,6.71,13
2022,3,09,11,2,36,제주특별자치도,39224,1639,40863,398977500,17831000,416808500,7.71,3.43,11
2022,3,09,18,3,37,제주특별자치도,33980,1354,35334,339226200,14235800,353462000,8.71,5.14,14
2022,3,09,25,4,38,제주특별자치도,16594,1835,18429,165582700,21897300,187480000,8.71,4.43,13
2022,4,10,02,5,39,제주특별자치도,15678,3249,18927,149288300,33777000,183065300,5.86,3.57,9
2022,4,10,09,1,40,제주특별자치도,16761,5152,21913,162743100,50605200,213348300,8.43,4.29,13
2022,4,10,16,2,41,제주특별자치도,9685,5061,14746,89894200,50701300,140595500,8.14,8.43,17
2022,4,10,23,3,42,제주특별자치도,5235,7747,12982,47748000,77210100,124958100,9.29,7.86,17
2022,4,10,30,4,43,제주특별자치도,7858,4425,12283,72812300,42636100,115448400,7.14,7.71,15
2022,4,11,06,1,44,제주특별자치도,6890,3587,10477,65321400,32601700,97923100,6.86,7.43,14
2022,4,11,13,2,45,제주특별자치도,3421,15317,18738,33034900,147800200,180835100,4.57,6,11
2022,4,11,20,3,46,제주특별자치도,10779,9698,20477,106232000,94653900,200885900,6.71,5.14,12
2022,4,11,27,4,47,제주특별자치도,15557,5076,20633,149608700,46692400,196301100,6.86,5.29,12
2022,4,12,04,1,48,제주특별자치도,21594,3653,25247,203761550,33125100,236886650,7.86,5.71,14
2022,4,12,11,2,49,제주특별자치도,14518,3446,17964,136043700,34752000,170795700,8.71,8.57,17
2022,4,12,18,3,50,제주특별자치도,8430,33973,42403,76955000,374246000,451201000,6.14,4.29,10
2022,4,12,25,4,51,제주특별자치도,17564,38259,55823,170021100,426718500,596739600,5.57,2.71,8
2023,1,01,01,5,52,제주특별자치도,18461,28904,47365,170354700,313903300,484258000,6.14,4,10
2022,1,01,09,1,1,충청남도,14706,32520,47226,144240370,311154840,455395210,2.29,17.71,20
2022,1,01,16,2,2,충청남도,16028,23820,39848,160467410,227239790,387707200,5.57,20.43,26
2022,1,01,23,3,3,충청남도,11183,18791,29974,112664130,166870810,279534940,4.29,21.29,26
2022,1,01,30,4,4,충청남도,30424,8752,39176,280730280,74851830,355582110,5.43,19.43,25
2022,1,02,06,1,5,충청남도,36705,7561,44266,357577650,67172000,424749650,5.71,17.86,24
2022,1,02,13,2,6,충청남도,9437,7988,17425,90909550,74088540,164998090,5.57,18.43,24
2022,1,02,20,3,7,충청남도,4401,20511,24912,34969410,196853020,231822430,6.14,17,23
2022,1,02,27,4,8,충청남도,3940,17444,21384,31780290,160661670,192441960,7.14,21,28
2022,1,03,06,1,9,충청남도,1761,21484,23245,14445310,210999160,225444470,7.29,17.71,25
2022,1,03,13,2,10,충청남도,8064,12886,20950,76155100,124594620,200749720,5,14.29,19
2022,1,03,20,3,11,충청남도,4956,10347,15303,45549340,100975000,146524340,4,16.86,21
2022,1,03,27,4,12,충청남도,10354,6733,17087,100145250,61892130,162037380,4.71,20.14,25
2022,2,04,03,5,13,충청남도,5311,14090,19401,49226530,130922670,180149200,4.57,16.29,21
2022,2,04,10,1,14,충청남도,3623,12710,16333,35444310,120053420,155497730,5.57,16.29,22
2022,2,04,17,2,15,충청남도,2274,19903,22177,21222600,198002210,219224810,6.43,11.29,18
2022,2,04,24,3,16,충청남도,6536,14016,20552,69498210,139994350,209492560,8.71,9.57,18
2022,2,05,01,4,17,충청남도,17092,14485,31577,163262150,136107450,299369600,10.29,13.57,24
2022,2,05,08,1,18,충청남도,7453,131093,138546,72003890,1336318340,1408322230,7.29,12,19
2022,2,05,15,2,19,충청남도,9903,51098,61001,101760490,517595410,619355900,5.14,12.14,17
2022,2,05,22,3,20,충청남도,125031,21970,147001,1310525200,215700160,1526225360,6.29,11.29,18
2022,2,05,29,4,21,충청남도,110061,10604,120665,1123639210,103960900,1227600110,7.29,7.43,15
2022,2,06,05,1,22,충청남도,82549,82104,164653,860388700,814565480,1674954180,8.57,8.43,17
2022,2,06,12,2,23,충청남도,77725,39503,117228,804961530,387964610,1192926140,7.43,4.71,12
2022,2,06,19,3,24,충청남도,101118,15160,116278,1054289740,149344380,1203634120,7.57,6.43,14
2022,2,06,26,4,25,충청남도,53954,47109,101063,567859610,486051820,1053911430,9.29,4.29,14
2022,3,07,03,5,26,충청남도,42925,55968,98893,435313070,565270210,1000583280,8.86,8.57,17
2022,3,07,10,1,27,충청남도,21238,98592,119830,223595370,1011279700,1234875070,7,10.57,18
2022,3,07,17,2,28,충청남도,14818,67639,82457,153611090,690147200,843758290,6.57,9.86,16
2022,3,07,24,3,29,충청남도,41983,65961,107944,440093150,654085730,1094178880,8,10.14,18
2022,3,07,31,4,30,충청남도,108497,44452,152949,1094809158,432873919,1527683077,7.14,7.14,14
2022,3,08,07,1,31,충청남도,144259,30501,174760,1447897384,298475379,1746372763,5.43,7.14,13
2022,3,08,14,2,32,충청남도,114650,19185,133835,1170761556,189306600,1360068156,6,11.86,18
2022,3,08,21,3,33,충청남도,86388,21993,108381,893033418,225567920,1118601338,8.29,15.14,23
2022,3,08,28,4,34,충청남도,51365,11034,62399,522094953,115247617,637342570,10.29,10.86,21
2022,3,09,04,1,35,충청남도,45466,7355,52821,438899949,75254818,514154767,9.14,11.57,21
2022,3,09,11,2,36,충청남도,122851,5339,128190,1269922709,56420085,1326342794,12,11.29,23
2022,3,09,18,3,37,충청남도,95348,4567,99915,977529260,47819875,1025349135,10.86,12,23
2022,3,09,25,4,38,충청남도,48635,4611,53246,493690061,58679158,552369219,12.14,9.71,22
2022,4,10,02,5,39,충청남도,48490,9331,57821,472135727,97475886,569611613,11.14,7.14,18
2022,4,10,09,1,40,충청남도,46659,14096,60755,457086105,145716416,602802521,16.29,7.71,24
2022,4,10,16,2,41,충청남도,28894,14007,42901,268331878,145299979,413631857,15.86,12.29,28
2022,4,10,23,3,42,충청남도,15825,23733,39558,137998848,239701286,377700134,14.43,12,26
2022,4,10,30,4,43,충청남도,23599,15284,38883,213837499,146935570,360773069,11.86,12.86,25
2022,4,11,06,1,44,충청남도,17853,9732,27585,167218285,89513731,256732016,15.71,13.86,30
2022,4,11,13,2,45,충청남도,7260,43178,50438,69823773,425856795,495680568,10.57,15.14,26
2022,4,11,20,3,46,충청남도,34183,27861,62044,335839936,267903305,603743241,10,13,23
2022,4,11,27,4,47,충청남도,46552,15162,61714,452954873,137498019,590452892,10.14,12.71,23
2022,4,12,04,1,48,충청남도,60064,13111,73175,568855995,112744793,681600788,13.29,14.43,28
2022,4,12,11,2,49,충청남도,44679,12642,57321,427907347,116995745,544903092,13.29,13.57,27
2022,4,12,18,3,50,충청남도,24295,98432,122727,230083381,1098159338,1328242719,9.43,11.86,21
2022,4,12,25,4,51,충청남도,42904,107205,150109,418557736,1215194967,1633752703,8,10.29,18
2023,1,01,01,5,52,충청남도,43400,74496,117896,413587916,836096145,1249684061,9,10.86,20
2022,1,01,09,1,1,충청북도,11030,22544,33574,105547360,214313530,319860890,2.57,11.43,14
2022,1,01,16,2,2,충청북도,12507,16718,29225,121541310,156342640,277883950,3.71,13.71,17
2022,1,01,23,3,3,충청북도,8479,13635,22114,82383080,119636590,202019670,3.57,15.29,19
2022,1,01,30,4,4,충청북도,23756,5891,29647,215715790,50837230,266553020,6.29,9.29,16
2022,1,02,06,1,5,충청북도,30520,5381,35901,293005620,48321960,341327580,6.57,6.86,13
2022,1,02,13,2,6,충청북도,7047,5522,12569,65846170,50844800,116690970,6.43,11.86,18
2022,1,02,20,3,7,충청북도,3251,15242,18493,25496200,143060360,168556560,5.43,13.43,19
2022,1,02,27,4,8,충청북도,2799,12339,15138,23091070,113431800,136522870,6.29,15.71,22
2022,1,03,06,1,9,충청북도,1351,15818,17169,11235300,151416040,162651340,6.57,13.43,20
2022,1,03,13,2,10,충청북도,6352,9714,16066,59305290,92669840,151975130,4.43,12,16
2022,1,03,20,3,11,충청북도,3695,7106,10801,34428900,68870270,103299170,3.29,14.29,18
2022,1,03,27,4,12,충청북도,7487,4494,11981,71277760,41990700,113268460,3.14,16.71,20
2022,2,04,03,5,13,충청북도,3699,9486,13185,33843100,87282200,121125300,3.43,16.57,20
2022,2,04,10,1,14,충청북도,2725,9033,11758,26010700,85458650,111469350,4.71,16.29,21
2022,2,04,17,2,15,충청북도,1773,14658,16431,16384000,142776880,159160880,5.86,11.57,17
2022,2,04,24,3,16,충청북도,5067,10583,15650,53593720,103828400,157422120,7,10.57,18
2022,2,05,01,4,17,충청북도,13404,10375,23779,124569590,95767060,220336650,10.14,12.14,22
2022,2,05,08,1,18,충청북도,6393,106312,112705,61908500,1060910000,1122818500,6,11.29,17
2022,2,05,15,2,19,충청북도,9174,41216,50390,96761700,412683560,509445260,4.14,11.29,15
2022,2,05,22,3,20,충청북도,105904,16417,122321,1086462080,163156600,1249618680,5.57,9.57,15
2022,2,05,29,4,21,충청북도,92680,8972,101652,927322970,86620130,1013943100,7.86,6.57,14
2022,2,06,05,1,22,충청북도,70425,65525,135950,714247310,637880780,1352128090,7.43,7.14,15
2022,2,06,12,2,23,충청북도,67085,29996,97081,682140860,289050960,971191820,5.43,5.71,11
2022,2,06,19,3,24,충청북도,84574,10672,95246,863282880,102784200,966067080,6.86,5.57,12
2022,2,06,26,4,25,충청북도,45838,39385,85223,467632320,397700260,865332580,9.14,5.14,14
2022,3,07,03,5,26,충청북도,37394,47136,84530,368790340,464149630,832939970,7.86,8.14,16
2022,3,07,10,1,27,충청북도,17862,83448,101310,179061320,865764800,1044826120,6.71,8.57,15
2022,3,07,17,2,28,충청북도,12481,55193,67674,129589420,562239840,691829260,6.86,11.14,18
2022,3,07,24,3,29,충청북도,33616,54951,88567,346722260,534460560,881182820,7,11.57,19
2022,3,07,31,4,30,충청북도,91160,35618,126778,904962359,341580480,1246542839,7.29,9.14,16
2022,3,08,07,1,31,충청북도,123102,24929,148031,1217232999,239282720,1456515719,6.57,8.14,15
2022,3,08,14,2,32,충청북도,96403,14707,111110,960962355,141142840,1102105195,7.29,9.14,16
2022,3,08,21,3,33,충청북도,74361,19071,93432,747011917,189373020,936384937,8.86,10.57,19
2022,3,08,28,4,34,충청북도,43088,9281,52369,428074717,96052160,524126877,9.29,11.57,21
2022,3,09,04,1,35,충청북도,37896,4478,42374,360917335,46686100,407603435,9,12.86,22
2022,3,09,11,2,36,충청북도,103664,4717,108381,1052670902,51801500,1104472402,9.86,13,23
2022,3,09,18,3,37,충청북도,80338,4152,84490,806547428,42965599,849513027,11.29,12.14,23
2022,3,09,25,4,38,충청북도,39639,3872,43511,400525711,52659320,453185031,13,7,20
2022,4,10,02,5,39,충청북도,40950,8657,49607,389400969,98098596,487499565,13,6.14,19
2022,4,10,09,1,40,충청북도,36353,11764,48117,350090652,123152796,473243448,13.71,6.86,21
2022,4,10,16,2,41,충청북도,21561,12252,33813,199843394,124686247,324529641,12.14,11.86,24
2022,4,10,23,3,42,충청북도,11630,17747,29377,102612791,177698904,280311695,14.57,11.86,26
2022,4,10,30,4,43,충청북도,17630,10981,28611,162490950,105666704,268157654,12.29,11,23
2022,4,11,06,1,44,충청북도,14027,7355,21382,135271902,70978187,206250089,11.14,12.43,24
2022,4,11,13,2,45,충청북도,5668,31749,37417,54416089,318940409,373356498,8.43,10.57,19
2022,4,11,20,3,46,충청북도,25999,19244,45243,250424625,193107968,443532593,10.43,9.57,20
2022,4,11,27,4,47,충청북도,39973,9936,49909,388898020,97251462,486149482,10.14,9,19
2022,4,12,04,1,48,충청북도,48461,8403,56864,460788605,79980375,540768980,10.29,9.71,20
2022,4,12,11,2,49,충청북도,39267,9428,48695,371500507,95472862,466973369,11.57,13.43,25
2022,4,12,18,3,50,충청북도,20480,90280,110760,188344426,1044159573,1232503999,9,10.29,19
2022,4,12,25,4,51,충청북도,35599,89202,124801,338460354,1055941278,1394401632,7.14,9.14,16
2023,1,01,01,5,52,충청북도,36702,65825,102527,347573810,781444257,1129018067,8.14,9.14,17
2023,1,01,08,1,1,강원도,22819,42485,65304,208568060,469622773,678190833,8.86,11.71,21
2023,1,01,15,2,2,강원도,15377,31491,46868,139714521,337364242,477078763,9.43,10.71,20
2023,1,01,22,3,3,강원도,30755,21634,52389,287522205,238726717,526248922,7.86,11.14,19
2023,1,01,29,4,4,강원도,36370,35119,71489,342455906,381138054,723593960,9.29,15.71,25
2023,1,02,05,1,5,강원도,11784,22781,34565,115498116,232704411,348202527,7.29,17,24
2023,1,02,12,2,6,강원도,7573,25635,33208,72577085,274595366,347172451,7.86,19.71,28
2023,1,01,08,1,1,경기도,225603,521201,746804,2276002542,6251668700,8527671242,17,15.29,32
2023,1,01,15,2,2,경기도,147302,409970,557272,1481786414,4811311887,6293098301,19.71,14.86,35
2023,1,01,22,3,3,경기도,299802,270772,570574,3109706263,3234655408,6344361671,12.86,15.43,28
2023,1,01,29,4,4,경기도,353014,437235,790249,3670645263,5053679068,8724324331,13.71,24.29,38
2023,1,02,05,1,5,경기도,92948,262704,355652,1040440793,2905637359,3946078152,13.14,27,40
2023,1,02,12,2,6,경기도,59066,286455,345521,643598492,3336470214,3980068706,12.71,28.29,41
2023,1,01,08,1,1,경상남도,48379,92678,141057,453797171,1012032172,1465829343,8.57,10.86,19
2023,1,01,15,2,2,경상남도,33170,67844,101014,309375856,724733893,1034109749,10.43,12.14,23
2023,1,01,22,3,3,경상남도,65942,44272,110214,648555289,480955135,1129510424,9,11,20
2023,1,01,29,4,4,경상남도,82402,75426,157828,805471608,806087460,1611559068,8.86,14.14,23
2023,1,02,05,1,5,경상남도,21702,42765,64467,232424250,431277348,663701598,8.57,15.14,24
2023,1,02,12,2,6,경상남도,13553,51896,65449,139980763,551102160,691082923,10,19,29
2023,1,01,08,1,1,경상북도,31457,56819,88276,300166889,581545411,881712300,9.29,8.71,18
2023,1,01,15,2,2,경상북도,20846,43846,64692,198359810,440598775,638958585,9.57,9.86,19
2023,1,01,22,3,3,경상북도,46842,26247,73089,464615762,269590043,734205805,9.29,9.71,19
2023,1,01,29,4,4,경상북도,58714,44817,103531,575427944,460109048,1035536992,9.71,12.57,22
2023,1,02,05,1,5,경상북도,13839,28497,42336,132773606,278900907,411674513,8.86,13.29,22
2023,1,02,12,2,6,경상북도,10457,32164,42621,95849626,327197073,423046699,8.43,17.57,26
2023,1,01,08,1,1,광주광역시,32305,57844,90149,306348700,695449924,1001798624,11.29,12.29,24
2023,1,01,15,2,2,광주광역시,21275,43617,64892,197239804,515893749,713133553,9.86,11.86,22
2023,1,01,22,3,3,광주광역시,41213,28539,69752,400142725,344515968,744658693,10,10.86,21
2023,1,01,29,4,4,광주광역시,52017,48470,100487,506949150,545060890,1052010040,12.14,15.29,27
2023,1,02,05,1,5,광주광역시,15647,32046,47693,164065252,340131451,504196703,12.57,16.71,29
2023,1,02,12,2,6,광주광역시,11348,36397,47745,116216699,405885191,522101890,10.57,18.86,29
2023,1,01,08,1,1,대구광역시,40774,89214,129988,399858093,1035750919,1435609012,12.71,12.86,26
2023,1,01,15,2,2,대구광역시,27131,68465,95596,264977645,791324358,1056302003,12.14,12.14,24
2023,1,01,22,3,3,대구광역시,57426,47726,105152,575340882,557926370,1133267252,10.57,10.71,21
2023,1,01,29,4,4,대구광역시,68083,76595,144678,683838198,856287778,1540125976,12.29,14.43,27
2023,1,02,05,1,5,대구광역시,18967,45456,64423,220228462,483563420,703791882,13.71,17.14,31
2023,1,02,12,2,6,대구광역시,11667,54732,66399,128926880,621510122,750437002,9.43,21.71,31
2023,1,01,08,1,1,대전광역시,29497,61384,90881,299626065,753288716,1052914781,11.14,11.57,23
2023,1,01,15,2,2,대전광역시,19529,45960,65489,195064426,553693709,748758135,10.57,11.71,22
2023,1,01,22,3,3,대전광역시,39634,31171,70805,406808206,387853836,794662042,9.14,12,21
2023,1,01,29,4,4,대전광역시,47121,49397,96518,487097130,580449749,1067546879,11,15.29,26
2023,1,02,05,1,5,대전광역시,13398,31970,45368,156747747,351970590,508718337,9.86,17.57,27
2023,1,02,12,2,6,대전광역시,8962,36130,45092,98937809,419157275,518095084,10.57,20.86,31
2023,1,01,08,1,1,부산광역시,63779,124678,188457,621819667,1423106117,2044925784,14.86,22.14,37
2023,1,01,15,2,2,부산광역시,41186,92737,133923,405552376,1043148513,1448700889,13.71,22.86,37
2023,1,01,22,3,3,부산광역시,83016,64650,147666,835430890,735407524,1570838414,11.29,18.86,30
2023,1,01,29,4,4,부산광역시,99794,105547,205341,995822109,1156208181,2152030290,12.86,23.71,37
2023,1,02,05,1,5,부산광역시,30406,64714,95120,345680808,668181090,1013861898,12.71,26.57,39
2023,1,02,12,2,6,부산광역시,20683,74385,95068,226182751,820187541,1046370292,11.71,30.86,43
2023,1,01,08,1,1,서울특별시,210770,510459,721229,2147640214,6283220161,8430860375,27,34.29,61
2023,1,01,15,2,2,서울특별시,150382,433111,583493,1526185211,5261037127,6787222338,32.43,39.43,72
2023,1,01,22,3,3,서울특별시,273341,311375,584716,2810461215,3779241178,6589702393,24.14,42.86,67
2023,1,01,29,4,4,서울특별시,290949,481546,772495,3053961379,5597960429,8651921808,23,53.29,76
2023,1,02,05,1,5,서울특별시,121902,331661,453563,1603769144,3734469533,5338238677,22.29,52.43,75
2023,1,02,12,2,6,서울특별시,81388,354472,435860,962736869,4166204355,5128941224,20.86,53,74
2023,1,01,08,1,1,세종특별자치시,4320,13006,17326,44471004,145955138,190426142,3.57,5.57,9
2023,1,01,15,2,2,세종특별자치시,2922,10894,13816,29898668,118450789,148349457,3.29,6,9
2023,1,01,22,3,3,세종특별자치시,6109,6390,12499,64101701,71557713,135659414,3.71,6,10
2023,1,01,29,4,4,세종특별자치시,7264,11316,18580,75209081,126727147,201936228,4.86,7.14,12
2023,1,02,05,1,5,세종특별자치시,2009,6584,8593,24299966,71581460,95881426,4.57,8.14,13
2023,1,02,12,2,6,세종특별자치시,1275,7704,8979,15222991,85222744,100445735,6.14,11.14,17
2023,1,01,08,1,1,울산광역시,19514,40220,59734,185477288,506538145,692015433,7.43,7.43,15
2023,1,01,15,2,2,울산광역시,13334,29852,43186,125370116,361514375,486884491,7,6.86,14
2023,1,01,22,3,3,울산광역시,28162,19935,48097,284964347,248464207,533428554,7.29,7,14
2023,1,01,29,4,4,울산광역시,36118,32471,68589,359557601,386396603,745954204,8.57,10,19
2023,1,02,05,1,5,울산광역시,9818,18924,28742,105637648,208675599,314313247,7.71,11.57,19
2023,1,02,12,2,6,울산광역시,6663,21627,28290,72725063,257756833,330481896,8.57,16,25
2023,1,01,08,1,1,인천광역시,46747,93794,140541,469732169,1088361454,1558093623,12.14,22,34
2023,1,01,15,2,2,인천광역시,30106,73850,103956,304362343,831801139,1136163482,13.29,21.43,35
2023,1,01,22,3,3,인천광역시,60034,51765,111799,623745753,591523615,1215269368,9,18.86,28
2023,1,01,29,4,4,인천광역시,71180,81130,152310,741322025,907835934,1649157959,12.57,24.71,37
2023,1,02,05,1,5,인천광역시,21399,50297,71696,236799449,537038897,773838346,11.14,25.71,37
2023,1,02,12,2,6,인천광역시,13909,54771,68680,147035395,616872562,763907957,12.29,26.43,39
2023,1,01,08,1,1,전라남도,22226,33542,55768,204812382,351025919,555838301,7.14,7.43,15
2023,1,01,15,2,2,전라남도,14936,25439,40375,134720990,256775176,391496166,6.86,7.14,14
2023,1,01,22,3,3,전라남도,32252,15334,47586,301132384,160482109,461614493,6.14,6.86,13
2023,1,01,29,4,4,전라남도,41807,26957,68764,390785325,277464396,668249721,7.14,8.57,16
2023,1,02,05,1,5,전라남도,11298,16640,27938,104153742,163430229,267583971,6.71,10.71,17
2023,1,02,12,2,6,전라남도,8826,19844,28670,79543046,206414056,285957102,6.57,14,21
2023,1,01,08,1,1,전라북도,28189,51701,79890,265885818,596592772,862478590,10.29,12.29,23
2023,1,01,15,2,2,전라북도,17191,37428,54619,163391063,427974311,591365374,8.86,11.14,20
2023,1,01,22,3,3,전라북도,39635,24796,64431,387868406,283219119,671087525,8,9,17
2023,1,01,29,4,4,전라북도,47551,41823,89374,467234477,456110926,923345403,8.57,11,20
2023,1,02,05,1,5,전라북도,13495,24871,38366,139508051,260343461,399851512,8.57,13.71,22
2023,1,02,12,2,6,전라북도,9791,28684,38475,92459473,314021149,406480622,10.29,17.57,28
2023,1,01,08,1,1,제주특별자치도,11484,23443,34927,113280300,254639300,367919600,4.57,6.14,11
2023,1,01,15,2,2,제주특별자치도,8430,18669,27099,82791900,201701500,284493400,4.29,5.29,10
2023,1,01,22,3,3,제주특별자치도,15848,12967,28815,162654900,138625600,301280500,4.57,5.71,10
2023,1,01,29,4,4,제주특별자치도,17106,18954,36060,178611900,202221800,380833700,6.43,8,14
2023,1,02,05,1,5,제주특별자치도,5390,12297,17687,59676600,126580400,186257000,5.29,9.43,15
2023,1,02,12,2,6,제주특별자치도,3331,14352,17683,35309500,153860800,189170300,7.14,10.29,17
2023,1,01,08,1,1,충청남도,31443,58895,90338,310796215,637030398,947826613,9.86,12.14,22
2023,1,01,15,2,2,충청남도,20326,45648,65974,201726032,491842111,693568143,9.14,13.86,23
2023,1,01,22,3,3,충청남도,43649,29183,72832,444763430,322204704,766968134,8.14,10.86,19
2023,1,01,29,4,4,충청남도,51815,47671,99486,530110720,519671195,1049781915,9.57,17.29,27
2023,1,02,05,1,5,충청남도,14352,30317,44669,151722147,314983043,466705190,7.43,19.43,27
2023,1,02,12,2,6,충청남도,10021,32697,42718,104618243,356605378,461223621,8.57,21.14,30
2023,1,01,08,1,1,충청북도,25328,46336,71664,242129791,532398781,774528572,8,10.14,18
2023,1,01,15,2,2,충청북도,16765,35305,52070,161676870,395110084,556786954,7.14,11.29,18
2023,1,01,22,3,3,충청북도,34580,21737,56317,348560144,246159945,594720089,7.86,9.71,18
2023,1,01,29,4,4,충청북도,42325,36909,79234,424112662,407001399,831114061,9,12.86,22
2023,1,02,05,1,5,충청북도,11878,23618,35496,124467643,247483798,371951441,7.29,15,22
2023,1,02,12,2,6,충청북도,7000,26704,33704,73388385,297788746,371177131,8.86,17.86,27
2023,1,02,19,3,7,강원도,4250,38549,42799,36910773,393174796,430085569,8.29,21.43,30
2023,1,02,19,3,7,경기도,34856,449408,484264,350273902,4947949585,5298223487,12.57,26.57,39
2023,1,02,19,3,7,경상남도,7552,76752,84304,69635333,781978164,851613497,10,18.86,29
2023,1,02,19,3,7,경상북도,5809,48923,54732,51959273,485920164,537879437,7.29,17.29,25
2023,1,02,19,3,7,광주광역시,6116,53073,59189,59049933,568062686,627112619,10.86,20.71,32
2023,1,02,19,3,7,대구광역시,6258,80112,86370,61400176,853898523,915298699,11.14,21.86,33
2023,1,02,19,3,7,대전광역시,4783,55046,59829,48589115,598844338,647433453,10,22.29,32
2023,1,02,19,3,7,부산광역시,10413,109533,119946,101179509,1152952654,1254132163,12.14,32,44
2023,1,02,19,3,7,서울특별시,48211,499381,547592,495293328,5641415232,6136708560,20.14,54.29,74
2023,1,02,19,3,7,세종특별자치시,824,11218,12042,7994890,121320440,129315330,4,8.71,13
2023,1,02,19,3,7,울산광역시,3789,32519,36308,37431289,357176940,394608229,7.71,15,23
2023,1,02,19,3,7,인천광역시,8390,87065,95455,79437896,933645958,1013083854,12,25.71,38
2023,1,02,19,3,7,전라남도,4182,31252,35434,36374197,307319504,343693701,5.86,14.29,20
2023,1,02,19,3,7,전라북도,4268,44904,49172,40445887,466900637,507346524,9.43,19.71,29
2023,1,02,19,3,7,제주특별자치도,1931,21086,23017,18485800,221852100,240337900,6,9,15
2023,1,02,19,3,7,충청남도,6160,53417,59577,59505788,560705003,620210791,9.86,20.57,30
2023,1,02,19,3,7,충청북도,4183,41324,45507,41166494,436499129,477665623,8.14,18.43,27
2023,1,02,26,4,8,강원도,9977,27133,37110,91370701,257974893,349345594,8.42857,18,26
2023,1,02,26,4,8,경기도,90085,303314,393399,885944329,3164900602,4050844931,11.57143,28.85714,40
2023,1,02,26,4,8,경상남도,23142,50114,73256,217107240,483792699,700899939,8.42857,19,27
2023,1,02,26,4,8,경상북도,14974,33397,48371,140687336,316993546,457680882,7.85714,16,24
2023,1,02,26,4,8,광주광역시,17483,35542,53025,161897364,355774351,517671715,10.14286,18.28571,28
2023,1,02,26,4,8,대구광역시,18308,53729,72037,176960520,534956756,711917276,9.71429,18.85714,29
2023,1,02,26,4,8,대전광역시,13096,38847,51943,128544491,398117029,526661520,9,20.57143,30
2023,1,02,26,4,8,부산광역시,29472,77558,107030,279782634,766172185,1045954819,11.28571,34.28571,46
2023,1,02,26,4,8,서울특별시,85839,359089,444928,838287764,3810576244,4648864008,20.42857,51.85714,72
2023,1,02,26,4,8,세종특별자치시,2127,7008,9135,21332198,71681114,93013312,3.85714,7.71429,12
2023,1,02,26,4,8,울산광역시,10467,21796,32263,101072335,225292677,326365012,6.85714,14.28571,21
2023,1,02,26,4,8,인천광역시,20535,57618,78153,199056797,585422780,784479577,11,27.14286,38
2023,1,02,26,4,8,전라남도,11566,19366,30932,105617701,179011919,284629620,6.57143,9.71429,16
2023,1,02,26,4,8,전라북도,13102,29103,42205,122613172,286639335,409252507,8.14286,19.28571,27
2023,1,02,26,4,8,제주특별자치도,5297,13651,18948,51957500,137039400,188996900,5.71429,9.28571,15
2023,1,02,26,4,8,충청남도,15494,35031,50525,151039992,346306182,497346174,8.14286,17.14286,25
2023,1,02,26,4,8,충청북도,12848,26379,39227,125885474,263262304,389147778,8.42857,15.57143,24
